Year,Country of origin,Country of origin (ISO),Country of asylum,Country of asylum (ISO),Female 0 - 4,Female 5 - 11,Female 12 - 17,Female 18 - 59,Female 60,Female other,Female total,Male 0 - 4,Male 5 - 11,Male 12 - 17,Male 18 - 59,Male 60,Male other,Male total,Total
2001,Afghanistan,AFG,-,-,192133,304109,260677,581853,40530,6664,1385966,195429,322895,276762,782758,57368,8718,1643930,3809763
2001,Albania,ALB,-,-,0,5,0,10,0,436,451,0,0,0,9,0,653,662,7627
2001,Algeria,DZA,-,-,9,0,14,23,0,304,350,10,11,10,93,0,556,680,8399
2001,Angola,AGO,-,-,12213,11425,9816,27376,2117,11626,74573,11401,12078,10357,22967,1827,14743,73373,470616
2001,Antigua and Barbuda,ATG,-,-,0,0,0,0,0,0,0,0,0,0,0,0,0,0,5
2001,Egypt,EGY,-,-,0,0,0,11,0,42,53,0,0,0,21,0,65,86,4677
2001,Argentina,ARG,-,-,0,0,0,5,0,0,5,0,0,0,0,0,0,0,660
2001,Armenia,ARM,-,-,13,22,18,68,0,257,378,11,23,21,69,5,244,373,7206
2001,Austria,AUT,-,-,0,0,0,0,0,0,0,0,0,0,0,0,0,0,27
2001,Azerbaijan,AZE,-,-,3725,5436,4672,63529,66040,131,143533,4011,5262,4514,55266,52140,124,121317,268755
2001,Bahrain,BHR,-,-,0,0,0,0,0,0,0,0,0,0,5,0,0,5,46
2001,Barbados,BRB,-,-,0,0,0,0,0,0,0,0,0,0,0,0,0,0,6
2001,Burundi,BDI,-,-,36236,33516,28735,73256,3531,95120,270394,36527,34596,29673,77432,3564,77256,259048,553987
2001,Belgium,BEL,-,-,0,0,0,0,0,0,0,0,0,0,0,0,0,0,11
2001,Benin,BEN,-,-,6,0,0,0,0,0,6,0,8,0,9,0,7,24,52
2001,Bangladesh,BGD,-,-,0,0,0,0,0,77,77,0,7,0,0,0,654,661,5544
2001,Bhutan,BTN,-,-,4480,9150,7842,25628,2231,5005,54336,4617,9393,8055,26355,3029,5009,56458,110844
2001,Burkina Faso,BFA,-,-,0,0,0,0,0,13,13,0,0,0,8,0,25,33,90
2001,Belarus,BLR,-,-,0,5,0,0,0,30,35,0,0,0,0,0,45,45,3691
2001,Bolivia (Plurinational State of),BOL,-,-,0,0,0,5,0,24,29,0,0,0,0,0,28,28,157
2001,Brazil,BRA,-,-,0,0,0,0,0,5,5,0,0,0,0,0,0,0,251
2001,Bosnia and Herzegovina,BIH,-,-,1633,8143,7008,56627,19446,5552,98409,1642,8527,7316,41596,13089,4957,77127,447326
2001,Bulgaria,BGR,-,-,0,5,0,0,7,60,72,0,0,0,0,0,107,107,2122
2001,Cambodia,KHM,-,-,5,7,5,44,0,9971,10032,5,7,12,41,5,9922,9992,34756
2001,Canada,CAN,-,-,0,0,0,0,0,0,0,0,0,0,0,0,0,0,5
2001,Central African Rep.,CAF,-,-,0,0,0,14,0,43,57,0,7,0,36,0,96,139,28698
2001,Chad,TCD,-,-,141,229,209,517,0,102,1198,148,303,257,823,0,251,1782,46282
2001,China,CHN,-,-,5,9,0,33,0,264,311,0,8,0,53,5,404,470,117403
2001,Chile,CHL,-,-,0,0,0,12,0,164,176,0,0,5,11,0,204,220,834
2001,Cameroon,CMR,-,-,5,5,0,19,0,58,87,0,0,0,75,0,108,183,2729
2001,Congo,COG,-,-,938,1292,1143,4311,154,416,8254,887,1493,1270,5667,121,432,9870,24237
2001,Dem. Rep. of the Congo,COD,-,-,20748,23104,19810,47795,2813,28006,142276,19857,23414,20074,43437,2309,31088,140179,392142
2001,Comoros,COM,-,-,0,0,0,0,0,0,0,0,0,0,0,0,0,0,25
2001,Colombia,COL,-,-,44,108,90,232,22,209,705,48,106,101,292,21,292,860,17937
2001,Costa Rica,CRI,-,-,0,0,0,0,0,0,0,0,0,0,0,0,0,0,86
2001,Cuba,CUB,-,-,0,34,24,299,10,57,424,6,27,25,185,22,96,361,18950
2001,Cabo Verde,CPV,-,-,0,0,0,0,0,0,0,0,0,0,0,0,5,5,5
2001,Cyprus,CYP,-,-,0,0,0,0,0,0,0,0,0,0,0,0,0,0,5
2001,Czechia,CZE,-,-,0,0,0,0,0,49,49,0,0,0,0,5,72,77,1177
2001,Denmark,DNK,-,-,0,0,0,0,0,0,0,0,0,0,0,0,0,0,5
2001,Djibouti,DJI,-,-,0,0,0,0,0,18,18,0,0,0,7,0,26,33,451
2001,Dominica,DMA,-,-,0,0,0,0,0,0,0,0,0,0,0,0,0,0,5
2001,Dominican Rep.,DOM,-,-,0,0,0,0,0,0,0,0,0,0,0,0,0,0,45
2001,Ecuador,ECU,-,-,0,0,0,0,0,13,13,0,0,0,0,0,16,16,649
2001,Equatorial Guinea,GNQ,-,-,0,0,0,5,0,13,18,6,5,0,7,0,12,30,526
2001,Eritrea,ERI,-,-,14835,13542,11595,28544,453,147,69116,13528,14647,12554,24817,344,155,66045,333222
2001,Estonia,EST,-,-,0,0,0,0,0,15,15,0,0,0,0,0,5,5,483
2001,Ethiopia,ETH,-,-,629,1445,1229,4248,90,832,8473,554,1402,1207,6483,95,623,10364,58980
2001,Fiji,FJI,-,-,0,0,0,0,0,0,0,0,0,0,0,0,0,0,731
2001,France,FRA,-,-,0,0,0,0,0,0,0,0,0,0,0,0,0,0,41
2001,Gabon,GAB,-,-,0,0,0,0,0,0,0,0,0,0,0,0,0,0,24
2001,Gambia,GMB,-,-,0,0,0,5,0,14,19,0,0,5,8,0,30,43,732
2001,Palestinian,PSE,-,-,60,186,143,642,116,39,1186,67,157,125,635,158,81,1223,349158
2001,United Kingdom of Great Britain and Northern Ireland,GBR,-,-,0,0,0,0,0,0,0,0,0,0,0,0,0,0,104
2001,Georgia,GEO,-,-,0,5,18,65,10,206,304,0,11,10,50,10,176,257,17490
2001,Germany,DEU,-,-,0,0,0,0,0,7,7,0,0,0,0,0,0,0,1028
2001,Ghana,GHA,-,-,1499,1413,1206,2552,55,334,7059,1475,906,773,1366,76,485,5081,14547
2001,Guinea-Bissau,GNB,-,-,0,0,0,0,0,232,232,5,0,0,0,0,625,630,917
2001,Greece,GRC,-,-,0,0,0,0,0,0,0,0,0,0,0,0,0,0,93
2001,Grenada,GRD,-,-,0,0,0,0,0,0,0,0,0,0,0,0,0,0,53
2001,Guatemala,GTM,-,-,800,1477,1265,2285,273,112,6212,796,1456,1249,2712,274,133,6620,16868
2001,Guinea,GIN,-,-,0,0,0,7,0,81,88,0,0,0,14,0,235,249,2009
2001,Guyana,GUY,-,-,0,0,0,0,0,0,0,0,0,0,0,0,0,0,36
2001,Haiti,HTI,-,-,0,6,0,13,0,672,691,0,7,0,22,0,744,773,7246
2001,"China, Hong Kong SAR",HKG,-,-,0,0,0,0,0,0,0,0,0,0,0,0,0,0,5
2001,Honduras,HND,-,-,0,0,5,11,0,36,52,0,5,0,19,0,39,63,783
2001,Croatia,HRV,-,-,2785,10622,9105,72883,29816,105,125316,2984,11197,9603,74761,21119,85,119749,290283
2001,Hungary,HUN,-,-,0,0,5,5,7,102,119,0,0,0,5,17,301,323,949
2001,Cote d'Ivoire,CIV,-,-,0,0,0,0,0,17,17,0,0,0,0,0,30,30,856
2001,India,IND,-,-,0,0,0,0,0,21,21,0,0,0,0,0,190,190,11560
2001,Indonesia,IDN,-,-,6,6,6,17,0,2229,2264,0,0,9,39,0,2718,2766,8972
2001,Ireland,IRL,-,-,0,0,0,0,0,0,0,0,0,0,0,0,0,0,5
2001,Iran (Islamic Rep. of),IRN,-,-,1608,2609,2276,5479,410,1256,13638,1619,2742,2339,6092,545,2083,15420,92490
2001,Iraq,IRQ,-,-,2220,18326,15723,121634,11495,1771,171169,2211,19592,16803,178974,10738,2667,230985,530508
2001,Israel,ISR,-,-,0,0,0,0,0,5,5,0,0,0,5,0,7,12,361
2001,Italy,ITA,-,-,0,0,0,0,0,5,5,0,0,0,0,0,0,0,36
2001,Jamaica,JAM,-,-,0,0,0,0,0,0,0,0,0,0,0,0,0,0,37
2001,Jordan,JOR,-,-,0,5,6,5,0,21,37,0,5,0,13,0,9,27,773
2001,Japan,JPN,-,-,0,0,0,0,0,0,0,0,0,0,0,0,0,0,5
2001,Kazakhstan,KAZ,-,-,0,0,0,7,0,29,36,0,0,0,5,5,37,47,2803
2001,Kenya,KEN,-,-,15,0,5,19,0,12,51,16,5,5,67,0,9,102,2551
2001,Kyrgyzstan,KGZ,-,-,0,8,0,0,0,5,13,0,0,0,0,0,5,5,687
2001,Rep. of Korea,KOR,-,-,0,0,0,0,0,0,0,0,0,0,0,0,0,0,83
2001,Dem. People's Rep. of Korea,PRK,-,-,0,0,0,0,0,0,0,0,0,0,0,0,0,0,17
2001,Kuwait,KWT,-,-,0,0,0,5,0,6,11,0,0,0,5,0,0,5,696
2001,Lao People's Dem. Rep.,LAO,-,-,0,0,7,5,0,4710,4722,5,6,5,6,0,5182,5204,12625
2001,Liberia,LBR,-,-,12917,20881,17895,39595,7585,60,98933,12235,20056,17207,34140,6699,126,90463,244603
2001,Libya,LBY,-,-,0,0,6,0,0,144,150,0,8,0,5,0,218,231,877
2001,Saint Lucia,LCA,-,-,0,0,0,0,0,0,0,0,0,0,0,0,0,0,9
2001,Lebanon,LBN,-,-,0,0,0,0,0,58,58,0,0,0,17,0,106,123,8754
2001,Sri Lanka,LKA,-,-,10,23,0,37,5,10186,10261,6,18,6,97,0,14999,15126,122414
2001,Lithuania,LTU,-,-,0,0,0,0,0,13,13,0,0,0,5,0,31,36,210
2001,Latvia,LVA,-,-,0,0,0,0,0,28,28,0,0,0,0,0,29,29,610
2001,"China, Macao SAR",MAC,-,-,0,0,0,0,0,0,0,0,0,0,0,0,0,0,5
2001,Madagascar,MDG,-,-,0,0,0,0,0,11,11,0,0,0,0,0,18,18,36
2001,Mauritania,MRT,-,-,3139,3634,3117,3915,680,287,14772,1888,2997,2570,3445,520,1547,12967,29850
2001,North Macedonia,MKD,-,-,476,945,815,3320,418,63,6037,540,1003,859,2203,292,77,4974,12192
2001,Rep. of Moldova,MDA,-,-,0,0,0,0,0,45,45,0,0,0,0,0,47,47,3731
2001,Mexico,MEX,-,-,0,0,0,0,0,0,0,0,0,0,0,0,0,0,1592
2001,Mali,MLI,-,-,0,0,0,9,0,18,27,0,5,0,6,0,90,101,311
2001,Malaysia,MYS,-,-,0,0,0,0,0,0,0,0,0,0,0,0,0,0,77
2001,Malawi,MWI,-,-,0,0,0,0,0,0,0,0,0,0,0,0,0,0,26
2001,Mongolia,MNG,-,-,0,0,0,0,0,0,0,0,0,0,0,0,0,0,57
2001,Morocco,MAR,-,-,0,0,0,0,0,42,42,0,0,0,0,0,88,88,357
2001,Mozambique,MOZ,-,-,0,0,0,0,0,5,5,0,0,0,0,0,6,6,45
2001,Malta,MLT,-,-,0,0,0,0,0,0,0,0,0,0,0,0,0,0,7
2001,Mauritius,MUS,-,-,0,0,0,5,0,0,5,0,0,0,19,0,6,25,30
2001,Myanmar,MMR,-,-,9518,12625,10811,30026,2056,46,65082,9902,13170,11285,31850,2124,146,68477,145849
2001,Namibia,NAM,-,-,107,145,123,371,37,0,783,117,157,127,1065,39,0,1505,2295
2001,Nepal,NPL,-,-,0,0,0,0,0,0,0,0,0,0,0,0,0,0,300
2001,Netherlands,NLD,-,-,0,0,0,0,0,0,0,0,0,0,0,0,0,0,5
2001,Niger,NER,-,-,0,0,0,0,0,0,0,0,0,0,0,0,10,10,478
2001,Nicaragua,NIC,-,-,14,45,31,306,24,49,469,11,34,41,307,31,51,475,4397
2001,Nigeria,NGA,-,-,28,18,8,56,0,59,169,12,23,19,126,0,132,312,6077
2001,Oman,OMN,-,-,0,0,0,0,0,0,0,0,0,0,0,0,0,0,5
2001,Pakistan,PAK,-,-,0,5,0,5,0,151,161,0,5,10,12,0,279,306,12326
2001,Panama,PAN,-,-,0,0,0,0,0,0,0,0,0,0,0,0,0,0,36
2001,Paraguay,PRY,-,-,0,0,0,0,0,0,0,0,0,0,0,0,0,0,6
2001,Peru,PER,-,-,17,24,16,137,5,179,378,15,28,24,144,0,217,428,6500
2001,Philippines,PHL,-,-,0,0,0,0,0,0,0,0,0,0,0,0,0,0,45469
2001,Papua New Guinea,PNG,-,-,0,0,0,0,0,0,0,0,0,0,0,0,0,0,6
2001,Poland,POL,-,-,0,0,5,0,0,499,504,0,0,0,5,5,537,547,3187
2001,Portugal,PRT,-,-,0,0,0,0,0,0,0,0,0,0,0,0,0,0,14
2001,Romania,ROU,-,-,0,0,0,0,6,299,305,0,0,0,5,0,290,295,6052
2001,South Africa,ZAF,-,-,5,0,0,5,0,5,15,0,0,0,0,0,24,24,131
2001,Russian Federation,RUS,-,-,471,828,712,2258,207,447,4923,499,864,735,1908,133,409,4548,45154
2001,Rwanda,RWA,-,-,3694,2563,2204,6630,115,2663,17869,3731,2920,2496,9950,102,3132,22331,84508
2001,El Salvador,SLV,-,-,12,152,133,893,103,364,1657,15,140,122,1047,101,391,1816,7147
2001,Saudi Arabia,SAU,-,-,0,0,0,0,0,0,0,0,0,0,0,0,0,0,29
2001,Serbia and Kosovo: S/RES/1244 (1999),SRB,-,-,414,499,425,1668,242,7846,11094,452,643,548,1739,176,9539,13097,144231
2001,Senegal,SEN,-,-,512,717,620,1956,236,13,4054,521,779,663,1401,282,53,3699,8554
2001,Seychelles,SYC,-,-,0,0,0,0,0,9,9,0,0,0,0,0,0,0,14
2001,Singapore,SGP,-,-,0,0,0,0,0,0,0,0,0,0,0,0,0,0,15
2001,Sierra Leone,SLE,-,-,8292,8229,7052,22838,3082,38,49531,7790,8586,7354,21828,2569,104,48231,179097
2001,Solomon Islands,SLB,-,-,0,0,0,0,0,0,0,0,0,0,0,0,0,0,42
2001,Somalia,SOM,-,-,16237,30581,26186,73306,5710,2999,155019,16637,31902,27354,65385,6314,2838,150430,440120
2001,Spain,ESP,-,-,0,0,0,0,0,0,0,0,0,0,0,0,0,0,45
2001,Viet Nam,VNM,-,-,5105,11432,9808,51817,11408,58960,148530,7449,12876,11048,54615,11150,66811,163949,353211
2001,Sao Tome and Principe,STP,-,-,0,0,0,0,0,0,0,0,0,0,0,0,0,0,21
2001,Sudan,SDN,-,-,31845,34315,29395,74855,3097,151,173658,34826,44796,38392,89100,3034,331,210479,489931
2001,Suriname,SUR,-,-,0,0,0,0,0,0,0,0,0,0,0,0,0,0,239
2001,Slovakia,SVK,-,-,0,0,0,0,0,39,39,0,0,0,0,0,39,39,189
2001,Slovenia,SVN,-,-,0,0,0,0,0,5,5,0,0,0,0,0,7,7,762
2001,Eswatini,SWZ,-,-,0,0,0,0,0,0,0,0,0,0,0,0,0,0,15
2001,Sweden,SWE,-,-,0,0,0,0,0,0,0,0,0,0,0,0,0,0,5
2001,Switzerland,CHE,-,-,0,0,0,0,0,0,0,0,0,0,0,0,0,0,60
2001,Syrian Arab Rep.,SYR,-,-,0,17,22,20,0,133,192,5,6,6,80,0,263,360,4861
2001,United Rep. of Tanzania,TZA,-,-,0,0,0,0,0,0,0,0,0,0,18,0,0,18,369
2001,Thailand,THA,-,-,0,0,0,0,0,0,0,0,0,0,0,0,0,0,90
2001,Tajikistan,TJK,-,-,1113,627,547,1609,117,5003,9016,890,858,730,1802,131,7392,11803,56107
2001,Turkmenistan,TKM,-,-,0,0,0,8,0,7,15,0,0,0,0,0,0,0,305
2001,Timor-Leste,TLS,-,-,0,0,0,0,0,35060,35060,0,0,0,0,0,37982,37982,73042
2001,Togo,TGO,-,-,116,131,121,649,16,87,1120,107,138,111,674,13,136,1179,4356
2001,Trinidad and Tobago,TTO,-,-,0,0,0,0,0,0,0,0,0,0,0,0,0,0,16
2001,Tunisia,TUN,-,-,0,5,0,12,0,267,284,0,0,8,19,0,565,592,1364
2001,Türkiye,TUR,-,-,844,1545,1330,2617,231,6344,12911,910,1563,1345,2572,218,10634,17242,47085
2001,Tuvalu,TUV,-,-,0,0,0,0,0,0,0,0,0,0,0,0,0,0,5
2001,United Arab Emirates,ARE,-,-,0,0,0,0,0,0,0,0,0,0,0,0,0,0,18
2001,Uganda,UGA,-,-,529,471,388,1129,26,24,2567,420,495,430,2134,31,51,3561,40133
2001,Ukraine,UKR,-,-,0,0,0,0,9,294,303,0,6,0,5,0,311,322,26712
2001,Uruguay,URY,-,-,0,0,0,0,0,0,0,0,0,0,0,0,0,0,45
2001,United States of America,USA,-,-,0,0,0,0,0,0,0,0,0,0,0,0,0,0,220
2001,Uzbekistan,UZB,-,-,0,0,0,0,0,12,12,0,0,0,0,0,13,13,3454
2001,Saint Vincent and the Grenadines,VCT,-,-,0,0,0,0,0,0,0,0,0,0,0,0,0,0,67
2001,Venezuela (Bolivarian Republic of),VEN,-,-,0,0,0,0,0,0,0,0,0,0,0,0,0,0,464
2001,Western Sahara,ESH,-,-,13038,15752,13501,33657,185,0,76133,13001,17254,14789,34237,917,7,80205,165908
2001,Yemen,YEM,-,-,49,140,125,318,16,13,661,59,119,101,411,10,15,715,1976
2001,Zambia,ZMB,-,-,0,0,0,0,0,0,0,0,0,0,7,0,0,7,55
2001,Zimbabwe,ZWE,-,-,0,0,0,0,0,0,0,0,0,0,5,0,0,5,257
2001,Stateless,XXA,-,-,0,8,7,37,95,271,418,8,14,6,67,40,520,655,7157
2001,Tibetan,TIB,-,-,0,0,0,0,0,0,0,0,0,0,0,0,0,0,20721
2001,Unknown ,,-,-,211,182,161,554,24,2406,3538,206,197,182,1014,25,2763,4387,1099538
2002,Afghanistan,AFG,-,-,101094,145027,124327,268674,19899,3388,662409,98672,143356,122870,199203,23440,4262,591803,2510294
2002,Albania,ALB,-,-,0,0,0,5,0,379,384,0,0,5,5,0,549,559,10758
2002,Algeria,DZA,-,-,0,5,0,27,0,241,273,19,5,0,75,0,480,579,12088
2002,Andorra,AND,-,-,0,0,0,0,0,0,0,0,0,0,0,0,0,0,9
2002,Angola,AGO,-,-,13361,15875,13632,30482,2649,697,76696,14664,15576,13348,30497,2015,1177,77277,435415
2002,Antigua and Barbuda,ATG,-,-,0,0,0,0,0,0,0,0,0,0,0,0,0,0,5
2002,Egypt,EGY,-,-,0,0,0,16,0,35,51,0,5,0,15,0,61,81,6442
2002,Argentina,ARG,-,-,0,0,0,0,0,0,0,0,0,0,0,0,0,0,764
2002,Armenia,ARM,-,-,12,22,18,69,0,256,377,11,23,15,69,5,231,354,13244
2002,Australia,AUS,-,-,0,0,0,0,0,0,0,0,0,0,0,0,0,0,9
2002,Austria,AUT,-,-,0,0,0,0,0,0,0,0,0,0,0,0,0,0,72
2002,Azerbaijan,AZE,-,-,10,32,39,90,24,103822,104017,0,31,40,145,11,88469,88696,260217
2002,Bahrain,BHR,-,-,0,0,0,0,0,0,0,0,0,0,5,0,0,5,49
2002,Barbados,BRB,-,-,0,0,0,0,0,0,0,0,0,0,0,0,0,0,6
2002,Burundi,BDI,-,-,38273,35329,30279,77004,3725,95026,279636,38219,36211,31073,81084,4081,77172,267840,574552
2002,Belgium,BEL,-,-,0,0,0,0,0,0,0,0,0,0,0,0,0,0,21
2002,Benin,BEN,-,-,0,0,6,0,0,0,6,0,7,0,10,0,6,23,228
2002,Bangladesh,BGD,-,-,0,0,0,0,0,98,98,0,7,0,5,0,706,718,5804
2002,Bhutan,BTN,-,-,4466,8996,7708,26626,2296,5005,55097,4812,9177,7867,27444,2871,5011,57182,112524
2002,Burkina Faso,BFA,-,-,0,0,0,0,0,6,6,0,0,0,8,0,22,30,970
2002,Belarus,BLR,-,-,0,5,0,0,0,41,46,0,0,0,0,0,49,49,6366
2002,Bolivia (Plurinational State of),BOL,-,-,0,0,0,5,0,11,16,0,0,0,0,0,14,14,215
2002,Botswana,BWA,-,-,0,0,0,0,0,0,0,0,0,0,0,0,0,0,5
2002,Brazil,BRA,-,-,0,0,0,0,0,6,6,0,0,0,0,0,0,0,438
2002,Bosnia and Herzegovina,BIH,-,-,58,320,284,2378,1802,3415,8257,51,367,308,1699,1059,3324,6808,406456
2002,Bulgaria,BGR,-,-,0,0,0,12,0,43,55,0,0,0,0,0,69,69,2843
2002,Cambodia,KHM,-,-,5,5,5,41,0,9280,9336,5,6,6,38,5,9065,9125,33451
2002,Canada,CAN,-,-,0,0,0,0,0,0,0,0,0,0,0,0,0,0,52
2002,Central African Rep.,CAF,-,-,1789,2204,1884,5685,46,80,11688,1333,2558,2191,7021,28,140,13271,25368
2002,Chad,TCD,-,-,225,306,264,667,10,110,1582,177,415,358,1381,24,290,2645,47340
2002,China,CHN,-,-,0,5,5,29,7,37411,37457,0,0,15,58,7,56087,56167,132099
2002,Chile,CHL,-,-,0,0,0,11,0,61,72,0,0,0,13,0,68,81,1705
2002,Cameroon,CMR,-,-,5,0,0,32,0,42,79,0,0,5,94,0,137,236,5228
2002,Congo,COG,-,-,1155,1396,1233,3803,126,599,8312,1123,1353,1165,4944,109,569,9263,27994
2002,Dem. Rep. of the Congo,COD,-,-,35923,40161,34421,78918,5356,3676,198455,34245,39205,33633,70294,4290,4381,186048,421355
2002,Comoros,COM,-,-,0,0,0,0,0,0,0,0,0,0,0,0,10,10,40
2002,Colombia,COL,-,-,124,331,296,2029,62,179,3021,132,378,338,2492,59,259,3658,30624
2002,Costa Rica,CRI,-,-,0,0,0,0,0,0,0,0,0,0,0,0,0,0,97
2002,Cuba,CUB,-,-,0,38,36,310,15,57,456,0,40,36,430,36,80,622,18035
2002,Cabo Verde,CPV,-,-,0,0,0,0,0,0,0,0,0,0,0,0,0,0,5
2002,Cyprus,CYP,-,-,0,0,0,0,0,0,0,0,0,0,0,0,0,0,5
2002,Czechia,CZE,-,-,0,0,0,0,0,29,29,0,0,0,0,5,35,40,6985
2002,Denmark,DNK,-,-,0,0,0,0,0,0,0,0,0,0,0,0,0,0,6
2002,Djibouti,DJI,-,-,0,5,0,20,0,18,43,0,0,6,24,0,24,54,470
2002,Dominica,DMA,-,-,0,0,0,0,0,0,0,0,0,0,0,0,0,0,6
2002,Dominican Rep.,DOM,-,-,0,0,0,0,0,0,0,0,0,0,0,0,0,0,82
2002,Ecuador,ECU,-,-,0,0,0,0,0,12,12,0,0,0,0,0,17,17,815
2002,Equatorial Guinea,GNQ,-,-,0,9,7,19,0,11,46,0,8,5,36,5,11,65,549
2002,Eritrea,ERI,-,-,8332,11801,10108,22938,2567,19,55765,8027,12534,10738,26369,2963,15,60646,318167
2002,Estonia,EST,-,-,0,0,0,0,0,9,9,0,0,0,0,0,5,5,1058
2002,Ethiopia,ETH,-,-,419,1090,926,3202,91,221,5949,446,1121,976,5251,113,236,8143,61235
2002,Fiji,FJI,-,-,0,0,0,0,0,0,0,0,0,0,0,0,0,0,1071
2002,Finland,FIN,-,-,0,0,0,0,0,0,0,0,0,0,0,0,0,0,8
2002,France,FRA,-,-,0,0,0,0,0,0,0,0,0,0,0,0,0,0,92
2002,Gabon,GAB,-,-,0,0,0,0,0,0,0,0,0,0,0,0,5,5,34
2002,Gambia,GMB,-,-,0,0,0,5,0,15,20,0,0,5,9,0,29,43,858
2002,Palestinian,PSE,-,-,66,187,152,668,105,30164,31342,72,168,145,540,142,41080,42147,428775
2002,United Kingdom of Great Britain and Northern Ireland,GBR,-,-,0,0,0,0,0,0,0,0,0,0,0,0,0,0,158
2002,Georgia,GEO,-,-,0,11,12,60,16,228,327,0,12,9,55,10,193,279,16970
2002,Germany,DEU,-,-,0,0,0,0,0,0,0,0,0,0,0,0,0,0,924
2002,Ghana,GHA,-,-,1496,1414,1206,2554,55,302,7027,1473,905,778,1369,75,458,5058,15675
2002,Guinea-Bissau,GNB,-,-,0,0,0,0,0,223,223,0,0,0,0,0,619,619,978
2002,Greece,GRC,-,-,0,0,0,0,0,0,0,0,0,0,0,0,0,0,296
2002,Grenada,GRD,-,-,0,0,0,0,0,0,0,0,0,0,0,0,0,0,73
2002,Guatemala,GTM,-,-,567,934,797,2578,205,6,5087,575,944,803,2852,201,11,5386,13892
2002,Guinea,GIN,-,-,0,7,9,0,0,99,115,0,0,0,17,0,236,253,3417
2002,Guyana,GUY,-,-,0,0,0,0,0,0,0,0,0,0,0,0,0,0,50
2002,Haiti,HTI,-,-,0,6,0,13,0,696,715,0,7,0,19,0,874,900,7722
2002,Honduras,HND,-,-,0,0,15,41,0,0,56,0,5,15,43,0,0,63,675
2002,Croatia,HRV,-,-,149,1087,931,7308,1756,50,11281,179,1162,1001,7369,1522,48,11281,274822
2002,Hungary,HUN,-,-,0,0,0,0,11,47,58,0,0,0,5,18,90,113,3515
2002,Iceland,ISL,-,-,0,0,0,0,0,0,0,0,0,0,0,0,0,0,13
2002,Cote d'Ivoire,CIV,-,-,2519,2013,1726,4417,463,35,11173,2168,2497,2142,3685,356,76,10924,23731
2002,India,IND,-,-,0,0,0,0,0,22,22,0,0,0,5,0,170,175,14349
2002,Indonesia,IDN,-,-,5,8,7,30,0,2229,2279,11,5,5,73,0,2718,2812,9907
2002,Ireland,IRL,-,-,0,0,0,0,0,0,0,0,0,0,0,0,0,0,5
2002,Iran (Islamic Rep. of),IRN,-,-,1488,2227,1949,4677,428,1032,11801,1482,2478,2131,5190,548,1688,13517,138362
2002,Iraq,IRQ,-,-,477,941,771,2021,136,1625,5971,501,1013,833,4594,150,2146,9237,422504
2002,Israel,ISR,-,-,0,0,5,0,0,0,5,0,0,0,11,0,0,11,561
2002,Italy,ITA,-,-,0,0,0,0,0,5,5,0,0,0,0,0,0,0,223
2002,Jamaica,JAM,-,-,0,0,0,0,0,0,0,0,0,0,0,0,0,0,147
2002,Jordan,JOR,-,-,0,7,6,5,0,8,26,0,0,6,13,0,6,25,1280
2002,Japan,JPN,-,-,0,0,0,0,0,0,0,0,0,0,0,0,0,0,14
2002,Kazakhstan,KAZ,-,-,0,0,0,7,0,49,56,0,0,0,5,5,53,63,6317
2002,Kenya,KEN,-,-,16,5,0,32,0,8,61,14,14,13,71,0,0,112,3089
2002,Kyrgyzstan,KGZ,-,-,0,8,0,0,0,6,14,0,0,0,0,0,6,6,2952
2002,Rep. of Korea,KOR,-,-,0,0,0,0,0,0,0,0,0,0,0,0,0,0,244
2002,Dem. People's Rep. of Korea,PRK,-,-,0,0,0,0,0,0,0,0,0,0,0,0,0,0,256
2002,Kuwait,KWT,-,-,0,0,0,0,0,0,0,0,0,0,0,0,0,0,705
2002,Lao People's Dem. Rep.,LAO,-,-,0,0,7,5,0,4398,4410,5,6,5,6,0,4682,4704,11233
2002,Liberia,LBR,-,-,15116,20891,17893,50372,7782,46,112100,17539,22000,18867,43141,7623,102,109272,275414
2002,Libya,LBY,-,-,0,0,6,0,0,154,160,0,0,0,5,0,231,236,1443
2002,Saint Lucia,LCA,-,-,0,0,0,0,0,0,0,0,0,0,0,0,0,0,12
2002,Lebanon,LBN,-,-,0,0,0,5,0,28,33,0,6,0,12,0,68,86,26313
2002,Lesotho,LSO,-,-,0,0,0,0,0,0,0,0,0,0,0,0,0,0,5
2002,Sri Lanka,LKA,-,-,0,15,9,18,0,38317,38359,0,21,0,75,0,42559,42655,133240
2002,Lithuania,LTU,-,-,0,0,0,0,0,0,0,0,0,0,5,0,12,17,1365
2002,Latvia,LVA,-,-,0,0,0,0,0,21,21,0,0,0,5,0,19,24,3080
2002,"China, Macao SAR",MAC,-,-,0,0,0,0,0,0,0,0,0,0,0,0,0,0,13
2002,Madagascar,MDG,-,-,0,0,0,0,0,14,14,0,0,0,0,0,17,17,52
2002,Mauritania,MRT,-,-,3139,3634,3116,3916,680,362,14847,1888,2994,2572,3466,520,1781,13221,30130
2002,North Macedonia,MKD,-,-,237,307,263,933,77,36,1853,261,357,306,735,79,59,1797,8102
2002,Rep. of Moldova,MDA,-,-,0,0,0,0,0,48,48,0,0,0,0,0,57,57,10121
2002,Mexico,MEX,-,-,0,0,0,0,0,0,0,0,0,0,0,0,0,0,1668
2002,Mali,MLI,-,-,0,0,0,9,0,21,30,0,5,6,0,0,94,105,525
2002,Malaysia,MYS,-,-,0,0,0,0,0,0,0,0,0,0,0,0,0,0,117
2002,Malawi,MWI,-,-,0,0,0,0,0,0,0,0,0,0,0,0,0,0,48
2002,Mongolia,MNG,-,-,0,0,0,0,0,8,8,0,0,0,0,0,0,0,277
2002,Morocco,MAR,-,-,0,0,0,0,0,31,31,0,0,0,0,0,71,71,1266
2002,Mozambique,MOZ,-,-,0,0,0,0,0,5,5,0,0,0,0,0,8,8,129
2002,Malta,MLT,-,-,0,0,0,0,0,0,0,0,0,0,0,0,0,0,7
2002,Mauritius,MUS,-,-,0,0,0,5,0,0,5,0,0,0,19,0,5,24,39
2002,Myanmar,MMR,-,-,9731,12490,10699,30923,2163,2077,68083,10038,13108,11230,32817,2195,3231,72619,148493
2002,Namibia,NAM,-,-,92,90,87,182,30,0,481,68,111,84,503,25,0,791,1298
2002,Nepal,NPL,-,-,0,0,0,0,0,0,0,0,0,0,0,0,0,0,899
2002,Netherlands,NLD,-,-,0,0,0,0,0,0,0,0,0,0,0,0,0,0,32
2002,Niger,NER,-,-,0,0,0,0,0,0,0,0,0,0,0,0,9,9,829
2002,Nicaragua,NIC,-,-,8,24,26,543,41,0,642,11,27,21,633,44,0,736,4049
2002,Nigeria,NGA,-,-,30,19,10,45,0,56,160,19,31,26,152,0,130,358,24559
2002,Norway,NOR,-,-,0,0,0,0,0,0,0,0,0,0,0,0,0,0,5
2002,Oman,OMN,-,-,0,0,0,0,0,0,0,0,0,0,0,0,0,0,19
2002,Pakistan,PAK,-,-,5,5,9,15,0,93,127,6,5,10,36,0,183,240,23164
2002,Panama,PAN,-,-,0,0,0,0,0,0,0,0,0,0,0,0,0,0,44
2002,Paraguay,PRY,-,-,0,0,0,0,0,0,0,0,0,0,0,0,0,0,26
2002,Peru,PER,-,-,10,17,15,140,5,142,329,9,22,26,157,0,191,405,6431
2002,Philippines,PHL,-,-,0,0,0,7,0,0,7,0,0,0,0,0,0,0,45606
2002,Papua New Guinea,PNG,-,-,0,0,0,0,0,0,0,0,0,0,0,0,0,0,12
2002,Poland,POL,-,-,0,0,0,0,0,146,146,0,0,0,5,5,122,132,16713
2002,Portugal,PRT,-,-,0,0,0,0,0,5,5,0,0,0,0,0,0,0,60
2002,Qatar,QAT,-,-,0,0,0,0,0,0,0,0,0,0,0,0,0,0,10
2002,Romania,ROU,-,-,0,0,0,0,6,199,205,0,0,0,0,0,188,188,8842
2002,South Africa,ZAF,-,-,5,0,0,5,0,5,15,0,0,0,0,0,13,13,271
2002,Russian Federation,RUS,-,-,391,443,374,1232,73,9147,11660,472,477,407,1150,54,6372,8932,91625
2002,Rwanda,RWA,-,-,4629,2744,2357,7226,210,1371,18537,4799,3154,2716,10886,377,1148,23080,75251
2002,El Salvador,SLV,-,-,5,121,107,1056,126,5,1420,11,101,88,1142,117,11,1470,6630
2002,Saudi Arabia,SAU,-,-,0,0,0,0,0,0,0,0,0,0,0,0,0,0,104
2002,Serbia and Kosovo: S/RES/1244 (1999),SRB,-,-,393,678,591,2871,408,3956,8897,420,775,675,2678,402,5012,9962,327582
2002,Senegal,SEN,-,-,512,718,620,1963,236,17,4066,529,782,660,1393,282,64,3710,12069
2002,Seychelles,SYC,-,-,0,0,0,0,0,7,7,0,0,0,0,0,0,0,43
2002,Singapore,SGP,-,-,0,0,0,0,0,0,0,0,0,0,0,0,0,0,40
2002,Sierra Leone,SLE,-,-,6921,6804,5857,16501,2007,44,38134,6600,6628,5650,15436,1611,142,36067,141473
2002,San Marino,SMR,-,-,0,0,0,0,0,0,0,0,0,0,0,0,0,0,5
2002,Solomon Islands,SLB,-,-,0,0,0,0,0,0,0,0,0,0,0,0,0,0,55
2002,Somalia,SOM,-,-,16717,25655,21988,68943,4157,893,138353,17766,28458,24392,73477,4261,928,149282,432304
2002,Spain,ESP,-,-,0,0,0,0,0,0,0,0,0,0,0,0,0,0,58
2002,Viet Nam,VNM,-,-,7679,16635,14259,84483,17831,7044,147931,10792,19192,16459,92826,17313,8178,164760,373732
2002,Sao Tome and Principe,STP,-,-,7,0,6,6,0,0,19,0,5,0,12,0,0,17,41
2002,Sudan,SDN,-,-,39168,38728,33197,83742,3550,127,198512,40129,48232,41371,97931,3071,283,231017,508863
2002,Suriname,SUR,-,-,0,0,0,0,0,0,0,0,0,0,0,0,0,0,101
2002,Slovakia,SVK,-,-,0,0,0,0,0,45,45,0,0,0,0,0,38,38,596
2002,Slovenia,SVN,-,-,0,0,0,0,0,0,0,0,0,0,0,0,0,0,853
2002,Eswatini,SWZ,-,-,0,0,0,0,0,0,0,0,0,0,0,0,0,0,20
2002,Sweden,SWE,-,-,0,0,0,0,0,0,0,0,0,0,0,0,0,0,27
2002,Switzerland,CHE,-,-,0,0,0,0,0,0,0,0,0,0,0,0,0,0,55
2002,Syrian Arab Rep.,SYR,-,-,13,15,17,22,0,98,165,15,17,17,93,0,212,354,18908
2002,United Rep. of Tanzania,TZA,-,-,0,0,0,0,0,0,0,0,5,5,9,0,0,19,578
2002,Thailand,THA,-,-,0,0,0,0,0,0,0,0,0,0,0,0,0,0,342
2002,Tajikistan,TJK,-,-,8676,3856,3315,12109,2339,1396,31691,7838,3486,2989,11253,2497,2094,30157,63264
2002,Turkmenistan,TKM,-,-,0,0,0,8,0,7,15,0,0,0,0,0,0,0,797
2002,Timor-Leste,TLS,-,-,0,0,0,0,0,0,0,0,0,0,0,0,0,0,28097
2002,Togo,TGO,-,-,111,107,98,541,7,66,930,111,92,94,484,7,142,930,10441
2002,Tonga,TON,-,-,0,0,0,0,0,0,0,0,0,0,0,0,0,0,7
2002,Trinidad and Tobago,TTO,-,-,0,0,0,0,0,0,0,0,0,0,0,0,0,0,35
2002,Tunisia,TUN,-,-,0,0,9,9,0,298,316,0,9,0,25,0,603,637,2543
2002,Türkiye,TUR,-,-,910,1566,1343,2429,752,5086,12086,973,1536,1313,2207,760,9294,16083,193697
2002,Tuvalu,TUV,-,-,0,0,0,0,0,0,0,0,0,0,0,0,0,0,5
2002,United Arab Emirates,ARE,-,-,0,0,0,0,0,0,0,0,0,0,0,0,0,0,29
2002,Uganda,UGA,-,-,764,869,732,1728,154,23,4270,617,763,648,2379,103,43,4553,40414
2002,Ukraine,UKR,-,-,0,0,0,8,0,226,234,0,0,0,12,0,221,233,85258
2002,Uruguay,URY,-,-,0,0,0,0,0,0,0,0,0,0,0,0,0,0,60
2002,United States of America,USA,-,-,0,0,0,0,0,0,0,0,0,0,0,0,0,0,383
2002,Uzbekistan,UZB,-,-,0,0,0,0,0,20,20,0,0,0,0,0,20,20,6882
2002,Saint Vincent and the Grenadines,VCT,-,-,0,0,0,0,0,0,0,0,0,0,0,0,0,0,81
2002,Venezuela (Bolivarian Republic of),VEN,-,-,0,0,0,0,0,0,0,0,0,0,0,0,0,0,525
2002,Western Sahara,ESH,-,-,11347,11550,9899,39019,6373,0,78188,11658,11916,10213,38893,5440,6,78126,165884
2002,Yemen,YEM,-,-,20,57,49,160,6,13,305,14,53,36,205,5,15,328,1595
2002,Zambia,ZMB,-,-,0,0,0,0,0,0,0,0,0,0,7,0,0,7,84
2002,Zimbabwe,ZWE,-,-,0,0,0,0,0,0,0,5,0,0,21,0,0,26,4024
2002,Stateless,XXA,-,-,0,5,0,8,90,0,103,0,0,14,31,40,0,85,14475
2002,Tibetan,TIB,-,-,0,0,0,0,0,0,0,0,0,0,0,0,0,0,20631
2002,Unknown ,,-,-,398,348,296,916,79,40374,42411,392,367,309,1036,68,59049,61221,289770
2003,Afghanistan,AFG,-,-,126179,163555,213203,384646,31183,2804,921570,131846,165122,223271,492483,39285,2704,1054711,2136039
2003,Albania,ALB,-,-,0,0,0,5,0,406,411,0,0,0,5,0,481,486,10382
2003,Algeria,DZA,-,-,10,5,9,20,0,299,343,20,12,0,60,0,572,664,11651
2003,Andorra,AND,-,-,0,0,0,0,0,0,0,0,0,0,0,0,0,0,7
2003,Angola,AGO,-,-,12892,14027,12043,25832,3020,711,68525,12053,13965,11972,24534,3006,1162,66692,329573
2003,Antigua and Barbuda,ATG,-,-,0,0,0,0,0,0,0,0,0,0,0,0,0,0,5
2003,Egypt,EGY,-,-,5,0,0,15,0,37,57,5,0,0,10,0,62,77,5734
2003,Argentina,ARG,-,-,0,0,0,0,0,0,0,0,0,0,0,0,0,0,777
2003,Armenia,ARM,-,-,13,22,18,68,0,294,415,9,19,17,71,5,284,405,13158
2003,Australia,AUS,-,-,0,0,0,0,0,0,0,0,0,0,0,0,0,0,12
2003,Austria,AUT,-,-,0,0,0,0,0,0,0,0,0,0,0,0,5,5,68
2003,Azerbaijan,AZE,-,-,15,28,24,99,22,100839,101027,5,34,25,149,12,85917,86142,253248
2003,Bahrain,BHR,-,-,0,0,0,0,0,0,0,0,0,0,0,0,0,0,50
2003,Barbados,BRB,-,-,0,0,0,0,0,0,0,0,0,0,0,0,0,0,8
2003,Burundi,BDI,-,-,40919,30151,25857,63645,3183,166,163921,40830,30978,26561,66974,3644,152,169139,531626
2003,Belgium,BEL,-,-,0,0,0,0,0,0,0,0,0,0,0,0,0,0,40
2003,Benin,BEN,-,-,0,0,0,0,0,0,0,0,0,0,0,0,6,6,274
2003,Bangladesh,BGD,-,-,0,0,0,0,0,113,113,5,7,0,0,0,729,741,5563
2003,Bhutan,BTN,-,-,3805,8671,7433,23962,2456,4565,50892,4051,8896,7625,24634,2997,4572,52775,103977
2003,Burkina Faso,BFA,-,-,0,0,0,0,0,6,6,0,0,0,7,0,19,26,852
2003,Belarus,BLR,-,-,0,5,0,5,0,72,82,0,0,0,0,0,94,94,7817
2003,Bolivia (Plurinational State of),BOL,-,-,0,0,0,0,0,11,11,0,0,0,0,0,14,14,260
2003,Botswana,BWA,-,-,0,0,0,0,0,0,0,0,0,0,0,0,0,0,5
2003,Brazil,BRA,-,-,0,0,0,0,0,5,5,0,0,0,0,0,0,0,377
2003,Bosnia and Herzegovina,BIH,-,-,49,246,216,1781,1230,3121,6643,47,290,259,1520,833,3083,6032,300012
2003,Bulgaria,BGR,-,-,0,0,0,12,0,39,51,0,0,0,0,0,63,63,2565
2003,Belize,BLZ,-,-,0,0,0,0,0,0,0,0,0,0,0,0,0,0,9
2003,Cambodia,KHM,-,-,0,5,5,38,0,16596,16644,7,7,0,26,5,13765,13810,31404
2003,Canada,CAN,-,-,0,0,0,0,0,0,0,0,0,0,0,0,0,0,61
2003,Central African Rep.,CAF,-,-,16,31,38,119,10,18276,18490,26,26,20,273,5,15144,15494,35394
2003,Chad,TCD,-,-,169,279,241,635,12,129,1465,183,320,279,1378,35,409,2604,52268
2003,China,CHN,-,-,5,0,8,32,0,386,431,13,7,14,49,5,532,620,132390
2003,Chile,CHL,-,-,0,0,0,5,5,49,59,0,0,0,5,0,52,57,1549
2003,Cameroon,CMR,-,-,10,0,0,28,0,63,101,0,5,0,100,0,180,285,6215
2003,Congo,COG,-,-,924,1365,1167,3715,137,834,8142,961,1297,1103,4978,126,782,9247,28950
2003,Dem. Rep. of the Congo,COD,-,-,41713,42295,36269,82684,6016,3159,212136,39349,41232,35336,74324,5090,3863,199194,453465
2003,Comoros,COM,-,-,0,0,0,0,0,5,5,0,0,0,5,0,15,20,62
2003,Colombia,COL,-,-,36,77,78,191,15,219,616,60,109,93,269,16,268,815,37992
2003,Costa Rica,CRI,-,-,0,0,0,0,0,0,0,0,0,0,0,0,0,0,91
2003,Cuba,CUB,-,-,0,29,26,192,10,54,311,5,26,24,256,22,74,407,16084
2003,Cabo Verde,CPV,-,-,0,0,0,0,0,0,0,0,0,0,0,0,0,0,7
2003,Cyprus,CYP,-,-,0,0,0,0,0,0,0,0,0,0,0,0,0,0,5
2003,Czechia,CZE,-,-,0,0,0,0,0,11,11,0,0,0,0,5,17,22,6699
2003,Denmark,DNK,-,-,0,0,0,0,0,0,0,0,0,0,0,0,0,0,10
2003,Djibouti,DJI,-,-,0,5,6,19,0,21,51,0,7,7,18,0,27,59,520
2003,Dominica,DMA,-,-,0,0,0,0,0,0,0,0,0,0,0,0,0,0,17
2003,Dominican Rep.,DOM,-,-,0,0,0,0,0,0,0,0,0,0,0,0,0,0,89
2003,Ecuador,ECU,-,-,0,0,0,0,0,14,14,0,0,0,0,0,22,22,720
2003,Equatorial Guinea,GNQ,-,-,0,10,9,22,0,13,54,0,7,12,40,5,12,76,584
2003,Eritrea,ERI,-,-,8077,10486,8981,20275,2681,22,50522,7938,11190,9594,24206,3964,16,56908,124111
2003,Estonia,EST,-,-,0,0,0,0,0,7,7,0,0,0,0,0,5,5,1021
2003,Ethiopia,ETH,-,-,483,1144,987,3583,90,219,6506,555,1211,1048,5682,120,240,8856,62674
2003,Fiji,FJI,-,-,0,0,0,0,0,0,0,0,0,0,0,0,0,0,1088
2003,Finland,FIN,-,-,0,0,0,0,0,0,0,0,0,0,0,0,0,0,6
2003,France,FRA,-,-,0,0,0,0,0,0,0,0,0,0,0,0,5,5,110
2003,Gabon,GAB,-,-,0,0,0,0,0,0,0,0,0,0,0,0,0,0,37
2003,Gambia,GMB,-,-,0,5,0,0,0,16,21,0,0,0,9,0,36,45,744
2003,Palestinian,PSE,-,-,945,1884,1633,6654,814,29,11959,969,1978,1672,6873,813,67,12372,350562
2003,United Kingdom of Great Britain and Northern Ireland,GBR,-,-,0,0,0,0,0,0,0,0,0,0,0,0,0,0,146
2003,Georgia,GEO,-,-,0,7,13,81,17,339,457,0,14,13,65,10,318,420,12488
2003,Germany,DEU,-,-,0,0,0,0,0,5,5,0,0,0,0,0,5,5,719
2003,Ghana,GHA,-,-,1496,1414,1206,2554,55,266,6991,1473,905,773,1369,75,418,5013,15866
2003,Guinea-Bissau,GNB,-,-,0,0,0,0,0,220,220,5,0,0,0,0,611,616,969
2003,Greece,GRC,-,-,0,0,0,0,0,0,0,0,0,0,0,0,0,0,268
2003,Grenada,GRD,-,-,0,0,0,0,0,0,0,0,0,0,0,0,0,0,76
2003,Guatemala,GTM,-,-,7,55,48,1265,297,5,1677,20,62,54,1819,266,11,2232,6696
2003,Guinea,GIN,-,-,0,7,8,0,0,138,153,0,0,0,19,0,282,301,3868
2003,Guyana,GUY,-,-,0,0,0,0,0,0,0,0,0,0,0,0,0,0,75
2003,Haiti,HTI,-,-,0,6,0,0,0,714,720,0,7,0,21,0,947,975,7550
2003,"China, Hong Kong SAR",HKG,-,-,0,0,0,0,0,0,0,0,0,0,0,0,0,0,6
2003,Honduras,HND,-,-,5,7,6,33,0,0,51,0,12,7,33,0,0,52,606
2003,Croatia,HRV,-,-,44,929,799,6639,1478,49,9938,59,1000,863,6739,1316,44,10021,230193
2003,Hungary,HUN,-,-,0,0,0,0,11,41,52,0,0,0,5,18,70,93,3394
2003,Iceland,ISL,-,-,0,0,0,0,0,0,0,0,0,0,0,0,0,0,11
2003,Cote d'Ivoire,CIV,-,-,975,822,717,1518,36,1481,5549,903,884,753,1851,49,1589,6029,33625
2003,India,IND,-,-,0,0,0,0,0,23,23,0,0,0,5,0,170,175,13703
2003,Indonesia,IDN,-,-,220,256,221,960,52,2400,4109,234,300,258,3139,49,2600,6580,16240
2003,Ireland,IRL,-,-,0,0,0,0,0,0,0,0,0,0,0,0,0,0,6
2003,Iran (Islamic Rep. of),IRN,-,-,373,1160,1007,3003,226,958,6727,397,1285,1113,3317,304,1520,7936,122530
2003,Iraq,IRQ,-,-,498,885,1533,3317,243,1631,8107,493,997,1675,5141,275,2069,10650,368577
2003,Israel,ISR,-,-,0,0,0,0,0,0,0,0,0,0,14,0,5,19,626
2003,Italy,ITA,-,-,0,0,0,0,0,0,0,0,0,0,0,0,0,0,208
2003,Jamaica,JAM,-,-,0,0,0,0,0,0,0,0,0,0,0,0,0,0,260
2003,Jordan,JOR,-,-,0,0,12,5,0,5,22,0,5,0,11,0,11,27,1149
2003,Japan,JPN,-,-,0,0,0,0,0,0,0,0,0,0,0,0,0,0,17
2003,Kazakhstan,KAZ,-,-,0,0,0,12,0,71,83,0,0,0,5,5,66,76,6563
2003,Kenya,KEN,-,-,0,5,0,27,0,5,37,5,5,0,21,0,6,37,3159
2003,Kyrgyzstan,KGZ,-,-,0,0,0,0,0,12,12,0,0,0,0,0,13,13,3142
2003,Kiribati,KIR,-,-,0,0,0,0,0,0,0,0,0,0,0,0,0,0,15
2003,Rep. of Korea,KOR,-,-,0,0,0,0,0,0,0,0,0,0,0,0,0,0,236
2003,Dem. People's Rep. of Korea,PRK,-,-,0,0,0,0,0,0,0,0,0,0,0,0,0,0,306
2003,Kuwait,KWT,-,-,0,0,0,0,0,0,0,0,0,7,0,0,0,7,615
2003,Lao People's Dem. Rep.,LAO,-,-,0,0,8,5,0,3971,3984,0,8,7,7,0,4246,4268,10360
2003,Liberia,LBR,-,-,25507,28770,24639,70789,10136,46,159887,27932,29392,25166,59011,5902,3256,150659,353340
2003,Libya,LBY,-,-,0,0,6,0,0,171,177,0,0,0,0,0,241,241,1553
2003,Saint Lucia,LCA,-,-,0,0,0,0,0,0,0,0,0,0,0,0,0,0,16
2003,Lebanon,LBN,-,-,0,0,0,0,0,28,28,0,5,0,18,0,66,89,24929
2003,Lesotho,LSO,-,-,0,0,0,0,0,0,0,0,0,0,0,0,0,0,5
2003,Sri Lanka,LKA,-,-,0,5,9,27,0,5874,5915,0,17,0,54,0,9715,9786,122005
2003,Lithuania,LTU,-,-,0,0,0,0,0,0,0,0,0,0,0,0,11,11,1535
2003,Latvia,LVA,-,-,0,0,0,0,0,23,23,0,0,0,0,0,18,18,3173
2003,"China, Macao SAR",MAC,-,-,0,0,0,0,0,0,0,0,0,0,0,0,0,0,13
2003,Madagascar,MDG,-,-,0,0,0,0,0,29,29,0,0,0,0,0,30,30,86
2003,Mauritania,MRT,-,-,3154,3639,3116,3915,680,427,14931,1908,2994,2572,3467,520,2336,13797,30518
2003,North Macedonia,MKD,-,-,95,122,104,350,30,46,747,102,140,120,260,70,73,765,5981
2003,Rep. of Moldova,MDA,-,-,0,0,0,0,0,64,64,0,0,0,0,0,80,80,11141
2003,Mexico,MEX,-,-,0,0,0,0,0,0,0,0,0,0,0,0,0,0,1650
2003,Mali,MLI,-,-,0,0,0,9,0,25,34,0,5,6,0,0,83,94,456
2003,Malaysia,MYS,-,-,0,0,0,0,0,0,0,0,0,0,0,0,0,0,235
2003,Malawi,MWI,-,-,0,0,0,0,0,0,0,0,0,0,0,0,0,0,60
2003,Mongolia,MNG,-,-,0,0,0,0,0,10,10,0,0,0,0,0,8,8,324
2003,Morocco,MAR,-,-,0,0,0,0,0,27,27,0,0,0,0,0,63,63,1291
2003,Mozambique,MOZ,-,-,0,0,0,0,0,5,5,0,0,0,0,0,8,8,106
2003,Malta,MLT,-,-,0,0,0,0,0,0,0,0,0,0,0,0,0,0,6
2003,Mauritius,MUS,-,-,0,0,0,5,0,0,5,0,0,0,42,0,0,42,54
2003,Myanmar,MMR,-,-,9309,13003,11140,33213,2328,76,69069,9806,13552,11622,37256,2398,146,74780,151370
2003,Namibia,NAM,-,-,0,0,5,12,0,0,17,0,5,0,8,5,0,18,1289
2003,Nepal,NPL,-,-,0,0,0,0,0,0,0,0,0,0,0,0,8,8,1232
2003,Netherlands,NLD,-,-,0,0,0,0,0,0,0,0,0,0,0,0,0,0,38
2003,Niger,NER,-,-,0,0,0,0,0,0,0,0,0,0,0,0,8,8,716
2003,Nicaragua,NIC,-,-,5,20,13,340,30,107,515,10,20,15,327,38,123,533,3984
2003,Nigeria,NGA,-,-,997,2194,1874,3795,160,68,9088,1100,2092,1781,3080,305,132,8490,24414
2003,Norway,NOR,-,-,0,0,0,0,0,0,0,0,0,0,0,0,0,0,5
2003,Nauru,NRU,-,-,0,0,0,0,0,0,0,0,0,0,0,0,0,0,5
2003,Oman,OMN,-,-,0,0,0,0,0,0,0,0,0,0,0,0,0,0,5
2003,Pakistan,PAK,-,-,9,0,8,17,0,87,121,7,5,0,42,0,186,240,24390
2003,Panama,PAN,-,-,0,0,0,0,0,0,0,0,0,0,0,0,0,0,29
2003,Paraguay,PRY,-,-,0,0,0,0,0,0,0,0,0,0,0,0,0,0,34
2003,Peru,PER,-,-,0,5,0,27,0,124,156,0,8,6,24,0,163,201,5578
2003,Philippines,PHL,-,-,0,0,0,0,0,0,0,0,0,0,7,0,0,7,409
2003,Papua New Guinea,PNG,-,-,0,0,0,0,0,0,0,0,0,0,0,0,0,0,12
2003,Poland,POL,-,-,0,0,0,0,0,116,116,0,0,0,5,5,101,111,15211
2003,Portugal,PRT,-,-,0,0,0,0,0,0,0,0,0,0,0,0,5,5,54
2003,Qatar,QAT,-,-,0,0,0,0,0,0,0,0,0,0,0,0,0,0,14
2003,Romania,ROU,-,-,0,0,0,0,6,154,160,0,0,0,0,0,152,152,8384
2003,South Africa,ZAF,-,-,5,0,0,5,0,5,15,0,0,0,0,0,11,11,284
2003,Russian Federation,RUS,-,-,323,467,387,1090,57,9592,11916,386,463,397,865,51,6865,9027,96414
2003,Rwanda,RWA,-,-,5230,2808,2432,7707,248,883,19308,5355,3240,2778,12261,396,695,24725,75258
2003,El Salvador,SLV,-,-,52,184,160,963,118,5,1482,46,176,152,1100,127,10,1611,5658
2003,Saudi Arabia,SAU,-,-,0,0,0,0,0,0,0,0,0,0,0,0,0,0,232
2003,Serbia and Kosovo: S/RES/1244 (1999),SRB,-,-,102,208,181,1155,197,3947,5790,111,299,260,1120,253,4910,6953,296627
2003,Senegal,SEN,-,-,524,701,599,2080,257,27,4188,537,751,642,1465,309,74,3778,8347
2003,Seychelles,SYC,-,-,0,0,0,0,0,6,6,0,0,0,0,0,0,0,37
2003,Singapore,SGP,-,-,0,0,0,0,0,0,0,0,0,0,0,0,0,0,35
2003,Sierra Leone,SLE,-,-,2810,3231,2778,8870,1290,70,19049,4723,4139,3552,8027,691,170,21302,70571
2003,Solomon Islands,SLB,-,-,0,0,0,0,0,0,0,0,0,0,0,0,0,0,61
2003,Somalia,SOM,-,-,15113,22974,19694,57944,3934,408,120067,16119,25583,21921,55836,4065,441,123965,402329
2003,Spain,ESP,-,-,0,0,0,0,0,0,0,0,0,0,0,0,0,0,51
2003,Viet Nam,VNM,-,-,8067,17023,14601,84389,18464,6026,148570,11197,19424,16664,92007,17606,7290,164188,363170
2003,Sao Tome and Principe,STP,-,-,0,6,6,7,0,0,19,0,0,5,12,0,0,17,41
2003,Sudan,SDN,-,-,35776,34462,29519,77214,3174,62834,242979,38259,43785,37533,93693,2611,47617,263498,606230
2003,Suriname,SUR,-,-,0,0,0,0,0,0,0,0,0,0,0,0,0,0,67
2003,Slovakia,SVK,-,-,0,0,0,0,0,50,50,0,0,0,0,0,41,41,668
2003,Slovenia,SVN,-,-,0,0,0,0,0,0,0,0,0,0,0,0,0,0,608
2003,Sweden,SWE,-,-,0,0,0,0,0,0,0,0,0,0,0,0,0,0,35
2003,Switzerland,CHE,-,-,0,0,0,0,0,0,0,0,0,0,0,0,0,0,34
2003,Syrian Arab Rep.,SYR,-,-,24,55,47,205,21,88,440,22,51,45,267,45,200,630,20816
2003,United Rep. of Tanzania,TZA,-,-,0,0,0,0,0,0,0,0,5,5,11,0,0,21,703
2003,Thailand,THA,-,-,0,0,0,0,0,0,0,0,0,0,0,0,0,0,295
2003,Tajikistan,TJK,-,-,8076,3477,2976,10153,2239,2252,29173,7193,3077,2647,9171,2384,2690,27162,58935
2003,Turkmenistan,TKM,-,-,0,0,0,8,0,7,15,0,0,0,0,0,0,0,836
2003,Timor-Leste,TLS,-,-,0,0,0,0,0,0,0,0,0,0,0,0,0,0,127
2003,Togo,TGO,-,-,114,125,120,603,13,85,1060,120,119,118,556,8,206,1127,10609
2003,Tonga,TON,-,-,0,0,0,0,0,0,0,0,0,0,0,0,0,0,11
2003,Trinidad and Tobago,TTO,-,-,0,0,0,0,0,0,0,0,0,0,0,0,0,0,39
2003,Tunisia,TUN,-,-,0,0,0,9,0,308,317,10,0,0,15,0,646,671,2562
2003,Türkiye,TUR,-,-,477,1513,1287,3090,287,4805,11459,555,1579,1366,2785,258,9021,15564,185086
2003,Tuvalu,TUV,-,-,0,0,0,0,0,0,0,0,0,0,0,0,0,0,5
2003,United Arab Emirates,ARE,-,-,0,0,0,0,0,0,0,0,0,0,0,0,0,0,16
2003,Uganda,UGA,-,-,579,604,524,1313,77,25,3122,470,572,499,2045,59,41,3686,35240
2003,Ukraine,UKR,-,-,0,0,0,0,0,281,281,0,0,0,0,0,254,254,94141
2003,Uruguay,URY,-,-,0,0,0,0,0,0,0,0,0,0,0,0,0,0,59
2003,United States of America,USA,-,-,0,0,0,0,0,0,0,0,0,0,0,0,0,0,394
2003,Uzbekistan,UZB,-,-,0,0,0,6,0,34,40,0,0,0,9,0,29,38,7394
2003,Saint Vincent and the Grenadines,VCT,-,-,0,0,0,0,0,0,0,0,0,0,0,0,0,0,105
2003,Venezuela (Bolivarian Republic of),VEN,-,-,0,0,0,0,0,0,0,0,0,0,5,0,0,5,598
2003,Western Sahara,ESH,-,-,14538,14856,12734,23713,10271,0,76112,14502,16360,14024,24879,10274,8,80047,165729
2003,Yemen,YEM,-,-,14,36,45,129,5,22,251,7,38,32,167,6,25,275,1588
2003,Zambia,ZMB,-,-,0,0,5,0,0,0,5,0,0,0,0,0,0,0,95
2003,Zimbabwe,ZWE,-,-,0,0,0,0,0,0,0,0,0,0,0,0,0,0,7154
2003,Stateless,XXA,-,-,0,5,0,8,90,225,328,0,0,0,50,35,483,568,13867
2003,Tibetan,TIB,-,-,0,0,0,0,0,0,0,0,0,0,0,0,0,0,20038
2003,Unknown ,,-,-,367,232,193,696,54,45,1587,172,249,208,1003,70,111,1813,320112
2004,Afghanistan,AFG,-,-,110672,157438,236075,401463,32130,456,938234,110975,160295,248414,435088,37681,571,993024,2414460
2004,Albania,ALB,-,-,0,5,6,20,5,25,61,5,7,6,24,0,29,71,10474
2004,Algeria,DZA,-,-,18,18,17,55,0,57,165,21,15,8,141,0,92,277,10650
2004,Angola,AGO,-,-,7176,8199,7043,14523,1459,25000,63400,7676,7603,6524,14508,1416,24036,61763,228842
2004,Antigua and Barbuda,ATG,-,-,0,0,0,0,0,0,0,0,0,0,0,0,0,0,13
2004,Egypt,EGY,-,-,0,0,0,11,0,8,19,0,6,0,24,0,24,54,5361
2004,Argentina,ARG,-,-,0,0,0,7,0,0,7,0,0,0,0,0,0,0,789
2004,Armenia,ARM,-,-,9,31,22,98,5,5,170,12,30,29,127,5,5,208,13409
2004,Australia,AUS,-,-,0,0,0,0,0,0,0,0,0,0,0,0,0,0,11
2004,Austria,AUT,-,-,0,0,0,0,0,0,0,0,0,0,0,0,0,0,44
2004,Azerbaijan,AZE,-,-,5,30,23,90,24,99220,99392,0,26,20,136,11,84521,84714,250584
2004,Bahrain,BHR,-,-,0,0,0,0,0,0,0,0,0,0,0,0,0,0,52
2004,Barbados,BRB,-,-,0,0,0,0,0,0,0,0,0,0,0,0,0,0,10
2004,Burundi,BDI,-,-,27047,23405,20055,54319,1866,249,126941,27037,23866,20453,55602,2244,265,129467,485753
2004,Belgium,BEL,-,-,0,0,0,0,0,0,0,0,0,0,0,0,0,0,41
2004,Benin,BEN,-,-,0,0,0,0,0,0,0,0,0,0,0,0,0,0,299
2004,Bangladesh,BGD,-,-,0,0,0,12,0,0,12,5,5,5,31,0,5,51,5733
2004,Bhutan,BTN,-,-,4112,8546,7325,28596,2780,20,51379,4352,8771,7518,29448,3447,0,53536,105259
2004,Burkina Faso,BFA,-,-,0,0,0,0,0,0,0,0,0,0,15,0,0,15,575
2004,Belarus,BLR,-,-,0,5,0,0,0,0,5,0,0,0,5,0,0,5,8226
2004,Bolivia (Plurinational State of),BOL,-,-,0,0,0,0,0,0,0,0,0,0,0,0,0,0,280
2004,Botswana,BWA,-,-,0,0,0,0,0,0,0,0,0,0,0,0,0,0,5
2004,Brazil,BRA,-,-,0,0,0,0,0,6,6,0,0,0,0,0,0,0,401
2004,Bosnia and Herzegovina,BIH,-,-,91,314,269,1885,900,2305,5764,101,358,323,1389,490,2158,4819,228813
2004,Bulgaria,BGR,-,-,0,0,0,18,0,6,24,0,0,0,5,0,6,11,2227
2004,Belize,BLZ,-,-,0,0,0,0,0,0,0,0,0,0,0,0,0,0,6
2004,Cambodia,KHM,-,-,0,13,7,60,5,1539,1624,0,12,6,54,10,1503,1585,18109
2004,Canada,CAN,-,-,0,0,0,0,0,0,0,0,0,0,0,0,0,0,57
2004,Central African Rep.,CAF,-,-,3633,3019,2589,6070,224,0,15535,3455,2782,2405,5373,314,0,14329,31056
2004,Chad,TCD,-,-,149,295,261,757,12,21,1495,208,356,296,1491,46,10,2407,52645
2004,China,CHN,-,-,10,11,0,54,0,245,320,18,0,5,146,0,299,468,134708
2004,Chile,CHL,-,-,0,0,5,5,0,12,22,0,8,0,5,0,11,24,1183
2004,Cameroon,CMR,-,-,10,0,0,62,0,6,78,0,5,0,154,0,18,177,7631
2004,Congo,COG,-,-,791,1246,1069,3538,142,28,6814,786,1248,1076,4932,164,22,8228,28140
2004,Dem. Rep. of the Congo,COD,-,-,35244,36411,31202,75730,4875,29169,212631,34695,37246,31922,67040,4027,25741,200671,462186
2004,Comoros,COM,-,-,0,5,0,0,0,0,5,0,0,0,10,0,0,10,52
2004,Colombia,COL,-,-,108,604,533,2779,103,96,4223,130,550,472,3929,140,101,5322,47380
2004,Costa Rica,CRI,-,-,0,0,0,0,0,0,0,0,0,0,0,0,0,0,136
2004,Cuba,CUB,-,-,5,40,27,304,20,21,417,5,27,34,518,27,19,630,15671
2004,Cabo Verde,CPV,-,-,0,0,0,0,0,0,0,0,0,0,0,0,0,0,5
2004,Czechia,CZE,-,-,0,0,0,0,0,0,0,0,0,0,5,5,0,10,4528
2004,Denmark,DNK,-,-,0,0,0,0,0,0,0,0,0,0,0,0,0,0,10
2004,Djibouti,DJI,-,-,8,0,0,17,0,0,25,7,0,0,26,0,0,33,492
2004,Dominica,DMA,-,-,0,0,0,0,0,0,0,0,0,0,0,0,0,0,24
2004,Dominican Rep.,DOM,-,-,0,5,0,0,0,0,5,0,0,0,0,0,0,0,93
2004,Ecuador,ECU,-,-,0,0,0,0,0,0,0,0,0,0,0,0,9,9,718
2004,Equatorial Guinea,GNQ,-,-,0,10,9,22,0,0,41,0,7,12,41,5,0,65,540
2004,Eritrea,ERI,-,-,403,490,422,1408,144,17447,20314,442,597,508,3416,190,26335,31488,131108
2004,Estonia,EST,-,-,0,0,0,0,0,0,0,0,0,0,0,0,0,0,849
2004,Ethiopia,ETH,-,-,626,1545,1335,2510,52,6568,12636,780,2729,2315,4055,110,7325,17314,63153
2004,Fiji,FJI,-,-,0,0,0,0,0,0,0,0,0,0,0,0,0,0,1280
2004,France,FRA,-,-,0,0,0,0,0,0,0,0,0,0,5,0,0,5,112
2004,Gabon,GAB,-,-,0,0,0,0,0,0,0,0,0,0,0,0,0,0,50
2004,Gambia,GMB,-,-,0,0,0,5,0,5,10,0,0,0,12,0,6,18,684
2004,Palestinian,PSE,-,-,1392,2594,2248,8584,977,79207,95002,1453,2844,2427,9733,914,160820,178191,349827
2004,United Kingdom of Great Britain and Northern Ireland,GBR,-,-,0,0,0,0,0,0,0,0,0,0,0,0,0,0,141
2004,Georgia,GEO,-,-,0,10,18,95,10,5,138,0,23,11,71,10,10,125,6620
2004,Germany,DEU,-,-,0,0,0,0,0,0,0,0,0,0,0,0,0,0,74
2004,Ghana,GHA,-,-,8,12,5,20,5,0,50,6,16,10,51,7,0,90,14759
2004,Guinea-Bissau,GNB,-,-,0,0,0,0,0,0,0,5,0,0,14,0,5,24,1008
2004,Greece,GRC,-,-,0,0,0,0,0,0,0,0,0,0,0,0,0,0,221
2004,Grenada,GRD,-,-,0,0,0,0,0,0,0,0,0,0,0,0,0,0,98
2004,Guatemala,GTM,-,-,5,31,27,840,62,0,965,14,52,44,1287,54,0,1451,4374
2004,Guinea,GIN,-,-,0,7,8,19,0,10,44,0,5,0,50,0,6,61,4777
2004,Guyana,GUY,-,-,0,0,0,0,0,0,0,0,0,0,0,0,0,0,191
2004,Haiti,HTI,-,-,0,6,0,5,0,0,11,0,0,0,30,0,0,30,9209
2004,"China, Hong Kong SAR",HKG,-,-,0,0,0,0,0,0,0,0,0,0,0,0,0,0,7
2004,Honduras,HND,-,-,7,0,0,23,0,0,30,5,0,5,27,0,0,37,485
2004,Croatia,HRV,-,-,43,921,780,6568,1451,18,9781,58,991,850,6658,1279,15,9851,215480
2004,Hungary,HUN,-,-,0,0,0,0,6,14,20,0,0,0,5,18,14,37,2747
2004,Iceland,ISL,-,-,0,0,0,0,0,0,0,0,0,0,0,0,0,0,8
2004,Cote d'Ivoire,CIV,-,-,579,840,722,1543,107,7,3798,520,838,725,2519,84,8,4694,23649
2004,India,IND,-,-,5,0,0,10,0,8,23,0,0,0,30,0,13,43,13335
2004,Indonesia,IDN,-,-,648,324,278,2945,64,2400,6659,674,405,347,11900,87,2600,16013,27919
2004,Ireland,IRL,-,-,0,0,0,0,0,0,0,0,0,0,0,0,0,0,5
2004,Iran (Islamic Rep. of),IRN,-,-,164,487,415,1739,88,346,3239,172,566,480,2353,115,467,4153,115171
2004,Iraq,IRQ,-,-,3615,5244,13568,23777,2012,1081,49297,3842,5762,14645,37883,2127,1319,65578,311889
2004,Israel,ISR,-,-,0,0,0,0,0,0,0,0,0,0,7,0,0,7,669
2004,Italy,ITA,-,-,0,0,0,0,0,0,0,0,0,0,0,0,0,0,192
2004,Jamaica,JAM,-,-,0,0,0,0,0,0,0,0,0,0,0,0,0,0,350
2004,Jordan,JOR,-,-,0,7,14,7,0,0,28,5,0,0,18,0,5,28,1158
2004,Japan,JPN,-,-,0,0,0,0,0,0,0,0,0,0,0,0,0,0,19
2004,Kazakhstan,KAZ,-,-,0,0,5,10,0,5,20,0,5,0,78,0,5,88,6124
2004,Kenya,KEN,-,-,0,5,0,22,0,0,27,10,0,6,21,0,0,37,3842
2004,Kyrgyzstan,KGZ,-,-,0,0,0,0,0,0,0,0,10,0,0,0,0,10,3286
2004,Kiribati,KIR,-,-,0,0,0,0,0,0,0,0,0,0,0,0,0,0,31
2004,Rep. of Korea,KOR,-,-,0,0,0,0,0,0,0,0,0,0,0,0,0,0,269
2004,Dem. People's Rep. of Korea,PRK,-,-,0,0,0,0,0,0,0,0,0,0,0,0,0,0,344
2004,Kuwait,KWT,-,-,0,0,0,0,0,0,0,0,0,0,0,0,0,0,391
2004,Lao People's Dem. Rep.,LAO,-,-,8,10,9,524,0,92,643,23,11,10,716,18,123,901,16114
2004,Liberia,LBR,-,-,22311,31632,27115,67222,6427,7,154714,25183,31718,27197,60507,5618,0,150223,335466
2004,Libya,LBY,-,-,0,0,5,0,0,176,181,0,0,5,5,0,230,240,1696
2004,Saint Lucia,LCA,-,-,0,0,0,0,0,0,0,0,0,0,0,0,0,0,32
2004,Lebanon,LBN,-,-,0,5,0,28,0,5,38,5,5,0,37,0,12,59,19854
2004,Lesotho,LSO,-,-,0,0,0,0,0,0,0,0,0,0,0,0,0,0,5
2004,Sri Lanka,LKA,-,-,152,167,143,654,135,206,1457,159,177,148,786,57,318,1645,114050
2004,Lithuania,LTU,-,-,0,0,0,0,0,0,0,0,0,0,0,0,0,0,1470
2004,Latvia,LVA,-,-,0,0,0,0,0,0,0,0,0,0,5,0,0,5,2822
2004,"China, Macao SAR",MAC,-,-,0,0,0,0,0,0,0,0,0,0,5,0,0,5,18
2004,Madagascar,MDG,-,-,0,0,0,0,0,0,0,0,0,0,0,0,0,0,132
2004,Mauritania,MRT,-,-,3156,3645,3120,3915,680,0,14516,1913,2999,2577,3478,520,0,11487,31104
2004,North Macedonia,MKD,-,-,55,77,67,231,25,15,470,60,84,72,153,39,27,435,5106
2004,Rep. of Moldova,MDA,-,-,0,0,0,5,0,0,5,0,0,0,0,0,7,7,11936
2004,Mexico,MEX,-,-,0,0,0,0,0,0,0,0,0,0,0,0,0,0,1740
2004,Mali,MLI,-,-,0,0,0,13,0,0,13,0,5,0,10,0,0,15,476
2004,Malaysia,MYS,-,-,0,0,0,0,0,0,0,0,0,0,0,0,0,0,287
2004,Malawi,MWI,-,-,0,0,0,0,0,0,0,0,0,0,7,0,0,7,95
2004,Mongolia,MNG,-,-,0,0,0,5,0,0,5,0,0,5,5,0,0,10,443
2004,Morocco,MAR,-,-,0,0,0,5,0,6,11,7,0,0,10,0,7,24,1313
2004,Mozambique,MOZ,-,-,0,0,0,0,0,0,0,5,0,0,0,0,0,5,94
2004,Mauritius,MUS,-,-,0,0,0,0,0,0,0,0,0,0,0,0,0,0,15
2004,Myanmar,MMR,-,-,9795,13622,11673,34798,2464,58,72410,10358,14083,12070,40533,2588,87,79719,160997
2004,Namibia,NAM,-,-,0,0,0,0,0,0,0,0,5,0,0,0,0,5,1307
2004,Nepal,NPL,-,-,0,0,0,0,0,0,0,0,0,0,0,0,0,0,1414
2004,Netherlands,NLD,-,-,0,0,0,0,0,0,0,0,0,0,0,0,0,0,45
2004,Niger,NER,-,-,0,0,0,0,0,0,0,0,0,0,0,0,0,0,676
2004,Nicaragua,NIC,-,-,5,8,13,370,25,0,421,5,11,10,350,45,0,421,1822
2004,Nigeria,NGA,-,-,1093,2120,1817,3826,153,0,9009,1194,1985,1706,2986,278,0,8149,23882
2004,Norway,NOR,-,-,0,0,0,0,0,0,0,0,0,0,0,0,0,0,5
2004,Oman,OMN,-,-,0,0,0,0,0,0,0,0,0,0,0,0,0,0,16
2004,Pakistan,PAK,-,-,19,16,12,60,0,36,143,5,24,22,120,0,55,226,25943
2004,Panama,PAN,-,-,0,0,0,0,0,0,0,0,0,0,0,0,0,0,38
2004,Paraguay,PRY,-,-,0,0,0,0,0,0,0,0,0,0,6,0,0,6,34
2004,Peru,PER,-,-,15,67,47,378,17,9,533,30,83,79,470,14,11,687,4767
2004,Philippines,PHL,-,-,0,0,0,0,0,0,0,0,0,0,5,0,0,5,428
2004,Papua New Guinea,PNG,-,-,0,0,0,0,0,0,0,0,0,0,0,0,0,0,12
2004,Poland,POL,-,-,0,0,0,0,0,9,9,0,0,0,5,5,7,17,10683
2004,Portugal,PRT,-,-,0,0,0,0,0,0,0,0,0,0,0,0,7,7,43
2004,Qatar,QAT,-,-,0,0,0,0,0,0,0,0,0,0,0,0,0,0,10
2004,Romania,ROU,-,-,0,0,0,12,6,27,45,5,0,0,6,0,17,28,6043
2004,South Africa,ZAF,-,-,5,0,0,0,0,0,5,7,0,0,9,0,0,16,261
2004,Russian Federation,RUS,-,-,1475,2980,2570,6730,527,45,14327,1724,2277,1961,4139,791,43,10935,108096
2004,Rwanda,RWA,-,-,4717,2665,2293,6523,262,752,17212,5079,2973,2549,8512,279,698,20090,63792
2004,El Salvador,SLV,-,-,52,133,114,879,110,0,1288,46,154,133,977,143,0,1453,4497
2004,Saudi Arabia,SAU,-,-,0,10,0,0,0,0,10,0,0,0,0,0,0,0,212
2004,Serbia and Kosovo: S/RES/1244 (1999),SRB,-,-,502,1124,956,3470,383,1418,7853,586,1239,1060,3281,345,1639,8150,237015
2004,Senegal,SEN,-,-,685,802,692,1500,113,0,3792,727,778,662,1259,169,0,3595,8325
2004,Seychelles,SYC,-,-,0,0,0,0,0,0,0,0,0,0,0,0,0,0,47
2004,Singapore,SGP,-,-,0,0,0,0,0,0,0,0,0,0,0,0,0,0,36
2004,Sierra Leone,SLE,-,-,612,1305,1113,3453,172,0,6655,712,1570,1357,4614,200,14,8467,41797
2004,Solomon Islands,SLB,-,-,0,0,0,0,0,0,0,0,0,0,0,0,0,0,61
2004,Somalia,SOM,-,-,13676,22305,19132,60719,3565,143,119540,14753,24618,21097,69859,3818,146,134291,389287
2004,Spain,ESP,-,-,0,0,0,0,0,0,0,0,0,0,0,0,0,0,53
2004,Viet Nam,VNM,-,-,14,15,24,109,10,145238,145410,13,24,32,291,11,157671,158042,349793
2004,Sao Tome and Principe,STP,-,-,0,6,6,7,0,0,19,0,0,5,12,0,0,17,36
2004,Sudan,SDN,-,-,61893,57596,49374,122406,8843,51,300163,62490,64328,55170,111754,6539,63,300344,730631
2004,Suriname,SUR,-,-,0,0,0,0,0,0,0,0,0,0,0,0,0,0,47
2004,Slovakia,SVK,-,-,0,0,0,0,0,8,8,0,0,0,0,0,0,0,618
2004,Slovenia,SVN,-,-,0,0,0,0,0,5,5,0,0,0,0,0,0,0,580
2004,Eswatini,SWZ,-,-,0,0,0,0,0,0,0,0,0,0,0,0,0,0,6
2004,Sweden,SWE,-,-,0,0,0,0,0,0,0,0,0,0,0,0,0,0,30
2004,Switzerland,CHE,-,-,0,0,0,0,0,0,0,0,0,0,0,0,0,0,11
2004,Syrian Arab Rep.,SYR,-,-,25,61,57,190,16,50,399,30,49,38,270,45,61,493,21430
2004,United Rep. of Tanzania,TZA,-,-,0,0,5,0,0,0,5,0,5,0,13,0,0,18,982
2004,Thailand,THA,-,-,0,0,0,0,0,0,0,0,0,0,0,0,0,0,320
2004,Tajikistan,TJK,-,-,8441,3795,3253,11471,2374,0,29334,7616,3362,2881,10479,2568,0,26906,56776
2004,Turkmenistan,TKM,-,-,0,5,0,0,0,7,12,5,0,0,5,0,0,10,815
2004,Timor-Leste,TLS,-,-,0,0,0,0,0,0,0,0,0,0,0,0,0,0,221
2004,Togo,TGO,-,-,124,118,110,585,11,42,990,127,94,99,521,8,65,914,10818
2004,Tonga,TON,-,-,0,0,0,0,0,0,0,0,0,0,0,0,0,0,5
2004,Trinidad and Tobago,TTO,-,-,0,0,0,0,0,0,0,0,0,0,0,0,0,0,38
2004,Tunisia,TUN,-,-,0,0,0,14,0,241,255,11,0,0,16,0,406,433,2511
2004,Türkiye,TUR,-,-,609,1546,1336,3339,314,1990,9134,690,1642,1402,3087,273,2862,9956,174572
2004,Tuvalu,TUV,-,-,0,0,0,0,0,0,0,0,0,0,0,0,0,0,5
2004,United Arab Emirates,ARE,-,-,0,0,0,0,0,0,0,0,0,0,0,0,0,0,69
2004,Uganda,UGA,-,-,238,381,335,622,88,3176,4840,219,309,258,721,60,4761,6328,31955
2004,Ukraine,UKR,-,-,0,0,0,16,0,7,23,0,0,10,11,0,6,27,89582
2004,Uruguay,URY,-,-,0,0,0,0,0,0,0,0,0,0,0,0,0,0,76
2004,United States of America,USA,-,-,0,0,0,0,0,0,0,0,0,0,0,0,0,0,451
2004,Uzbekistan,UZB,-,-,0,11,0,0,0,0,11,0,0,11,0,0,8,19,7292
2004,Saint Vincent and the Grenadines,VCT,-,-,0,0,0,0,0,0,0,0,0,0,0,0,0,0,181
2004,Venezuela (Bolivarian Republic of),VEN,-,-,0,0,0,0,0,0,0,0,0,0,9,0,0,9,1251
2004,Western Sahara,ESH,-,-,14538,14856,12734,23715,10271,0,76114,14502,16337,14004,24918,10274,9,80044,165728
2004,Yemen,YEM,-,-,11,37,33,141,5,25,252,6,34,24,159,6,29,258,1599
2004,Zambia,ZMB,-,-,0,0,0,5,0,0,5,0,0,0,7,0,0,7,119
2004,Zimbabwe,ZWE,-,-,0,0,0,0,0,0,0,0,0,0,0,0,0,0,9557
2004,Stateless,XXA,-,-,0,12,18,29,0,16,75,5,13,15,64,0,41,138,13883
2004,Tibetan,TIB,-,-,0,0,0,0,0,9536,9536,0,0,0,0,0,10464,10464,20038
2004,Unknown ,,-,-,26,65,49,281,39,66911,67371,13,64,69,525,69,84538,85278,351195
2005,Afghanistan,AFG,-,-,19337,45601,139767,197060,9633,532842,944240,19636,50456,153509,282827,18821,554593,1079842,2166139
2005,Albania,ALB,-,-,0,6,6,24,5,555,596,5,6,6,26,0,620,663,12718
2005,Algeria,DZA,-,-,8,27,32,44,0,428,539,6,31,23,150,0,785,995,12024
2005,Andorra,AND,-,-,0,0,0,0,0,0,0,0,0,0,0,0,0,0,10
2005,Angola,AGO,-,-,7772,9293,7975,20744,2680,973,49437,8212,8866,7610,19030,2328,1534,47580,215811
2005,Antigua and Barbuda,ATG,-,-,0,0,0,0,0,0,0,0,0,0,0,0,0,0,13
2005,Egypt,EGY,-,-,0,0,0,11,0,45,56,5,0,0,19,0,82,106,6288
2005,Argentina,ARG,-,-,0,0,0,0,0,0,0,0,0,0,0,0,0,0,850
2005,Armenia,ARM,-,-,5,36,25,122,5,658,851,5,38,26,142,5,628,844,13965
2005,Australia,AUS,-,-,0,0,0,0,0,0,0,0,0,0,0,0,0,0,41
2005,Austria,AUT,-,-,0,0,0,0,0,0,0,0,0,0,0,0,0,0,62
2005,Azerbaijan,AZE,-,-,0,24,13,160,50,125423,125670,0,16,10,224,45,94729,95024,233678
2005,Bahrain,BHR,-,-,0,0,0,0,0,0,0,0,0,0,0,0,0,0,40
2005,Barbados,BRB,-,-,0,0,0,0,0,0,0,0,0,0,0,0,0,0,8
2005,Burundi,BDI,-,-,21572,19245,16503,42780,1926,380,102406,23168,18629,15969,43303,2372,404,103845,438695
2005,Belgium,BEL,-,-,0,0,0,0,0,0,0,0,0,0,0,0,0,0,95
2005,Benin,BEN,-,-,0,0,0,0,0,9,9,0,0,0,0,0,8,8,402
2005,Bangladesh,BGD,-,-,0,0,0,7,0,147,154,0,8,0,35,0,1062,1105,7303
2005,Bhutan,BTN,-,-,4813,8569,7344,28605,2695,5,52031,5126,8789,7534,29419,3354,14,54236,106539
2005,Burkina Faso,BFA,-,-,0,0,0,0,0,6,6,0,0,0,14,0,26,40,602
2005,Belarus,BLR,-,-,0,5,0,0,0,141,146,0,0,0,9,0,163,172,8849
2005,Bolivia (Plurinational State of),BOL,-,-,0,0,0,0,0,11,11,0,0,0,0,0,14,14,263
2005,Brazil,BRA,-,-,0,0,0,0,0,6,6,0,0,0,0,0,0,0,370
2005,Brunei Darussalam,BRN,-,-,0,0,0,0,0,0,0,0,0,0,0,0,0,0,47
2005,Bosnia and Herzegovina,BIH,-,-,68,233,203,1477,756,3733,6470,72,265,232,1087,391,3801,5848,109931
2005,Bulgaria,BGR,-,-,0,0,0,10,0,36,46,0,0,0,0,0,51,51,4250
2005,Belize,BLZ,-,-,0,0,0,0,0,0,0,0,0,0,0,0,0,0,5
2005,Cambodia,KHM,-,-,0,7,13,74,5,8505,8604,0,13,6,63,11,8260,8353,17804
2005,Canada,CAN,-,-,0,0,0,0,0,0,0,0,0,0,0,0,0,0,120
2005,Central African Rep.,CAF,-,-,5108,4350,3719,8735,335,189,22436,4926,3664,3149,6949,491,251,19430,42875
2005,Chad,TCD,-,-,109,201,169,577,7,186,1249,114,173,122,1087,22,569,2087,48389
2005,China,CHN,-,-,0,32,6,69,0,423,530,21,5,5,175,0,561,767,124086
2005,Chile,CHL,-,-,0,0,0,10,0,43,53,0,0,0,13,0,40,53,929
2005,Cameroon,CMR,-,-,20,0,0,47,0,131,198,0,5,0,143,0,320,468,9096
2005,Congo,COG,-,-,643,781,677,2482,85,1275,5943,650,772,660,3512,92,1246,6932,24428
2005,Dem. Rep. of the Congo,COD,-,-,33521,34959,29947,72387,4896,4645,180355,36162,35897,30759,64330,3697,5512,176357,430919
2005,Comoros,COM,-,-,0,0,0,0,0,6,6,0,0,0,5,0,21,26,64
2005,Colombia,COL,-,-,90,142,128,477,21,218,1076,101,133,115,660,36,290,1335,60447
2005,Costa Rica,CRI,-,-,0,0,0,0,0,0,0,0,0,0,0,0,0,0,176
2005,Cuba,CUB,-,-,6,36,27,312,15,58,454,14,28,27,551,32,80,732,19003
2005,Cyprus,CYP,-,-,0,0,0,0,0,0,0,0,0,0,0,0,0,0,5
2005,Czechia,CZE,-,-,0,0,0,0,0,19,19,0,0,0,0,5,22,27,3589
2005,Denmark,DNK,-,-,0,0,0,0,0,0,0,0,0,0,0,0,0,0,10
2005,Djibouti,DJI,-,-,7,0,0,14,0,29,50,9,0,0,21,0,29,59,498
2005,Dominica,DMA,-,-,0,0,0,0,0,0,0,0,0,0,0,0,0,0,30
2005,Dominican Rep.,DOM,-,-,0,5,0,0,0,0,5,0,0,0,0,0,0,0,62
2005,Ecuador,ECU,-,-,5,0,0,0,0,17,22,0,0,0,0,0,24,24,772
2005,Equatorial Guinea,GNQ,-,-,0,0,8,17,0,12,37,0,13,0,19,0,17,49,478
2005,Eritrea,ERI,-,-,509,494,449,1916,149,47,3564,544,539,468,6915,24,239,8729,144062
2005,Estonia,EST,-,-,0,0,0,0,0,6,6,0,0,0,0,0,5,5,738
2005,Ethiopia,ETH,-,-,624,695,601,4362,41,257,6580,686,846,715,9235,202,253,11937,65447
2005,Fiji,FJI,-,-,0,0,0,0,0,0,0,0,0,0,0,0,0,0,1376
2005,Finland,FIN,-,-,0,0,0,0,0,0,0,0,0,0,0,0,0,0,5
2005,France,FRA,-,-,0,0,0,0,0,0,0,0,0,0,5,0,0,5,286
2005,Gabon,GAB,-,-,0,0,0,0,0,0,0,0,0,0,0,0,6,6,78
2005,Gambia,GMB,-,-,0,0,0,5,0,17,22,0,0,0,12,0,38,50,1680
2005,Palestinian,PSE,-,-,660,1913,1631,6796,890,46,11936,713,2026,1744,7184,934,116,12717,349663
2005,United Kingdom of Great Britain and Northern Ireland,GBR,-,-,0,0,0,0,0,0,0,0,0,0,0,0,0,0,134
2005,Georgia,GEO,-,-,0,14,17,101,10,787,929,0,25,12,87,5,749,878,7289
2005,Germany,DEU,-,-,0,0,0,0,0,9,9,0,0,0,0,0,0,0,75
2005,Ghana,GHA,-,-,0,7,7,32,0,245,291,0,5,5,42,5,390,447,18421
2005,Guinea-Bissau,GNB,-,-,0,0,0,0,0,234,234,5,6,0,7,0,617,635,1042
2005,Greece,GRC,-,-,0,0,0,0,0,0,0,0,0,0,0,0,0,0,333
2005,Grenada,GRD,-,-,0,0,0,0,0,0,0,0,0,0,0,0,0,0,151
2005,Guatemala,GTM,-,-,0,18,16,407,38,5,484,5,7,6,186,565,10,779,3376
2005,Guinea,GIN,-,-,0,7,0,24,0,289,320,0,0,6,71,0,608,685,5816
2005,Guyana,GUY,-,-,0,0,0,0,0,0,0,0,0,0,0,0,0,0,405
2005,Haiti,HTI,-,-,0,5,5,12,0,962,984,0,0,0,50,0,1275,1325,13538
2005,Honduras,HND,-,-,0,5,0,19,0,0,24,0,5,0,30,0,0,35,536
2005,Croatia,HRV,-,-,98,303,266,2614,486,54,3821,67,329,284,2646,409,47,3782,119154
2005,Hungary,HUN,-,-,0,0,0,0,0,35,35,0,0,0,0,16,48,64,3516
2005,Iceland,ISL,-,-,0,0,0,0,0,0,0,0,0,0,0,0,0,0,10
2005,Cote d'Ivoire,CIV,-,-,878,1098,942,2674,208,311,6111,896,1198,1021,3887,226,793,8021,18333
2005,India,IND,-,-,0,0,5,10,0,37,52,0,5,0,31,0,189,225,16275
2005,Indonesia,IDN,-,-,766,413,349,3618,76,0,5222,852,491,412,14593,87,0,16435,34383
2005,Ireland,IRL,-,-,0,0,0,0,0,0,0,0,0,0,0,0,0,0,23
2005,Iran (Islamic Rep. of),IRN,-,-,210,878,749,2725,183,1065,5810,215,1004,910,3266,273,1683,7351,99430
2005,Iraq,IRQ,-,-,2825,4387,9076,18916,1624,1656,38484,2952,4797,9712,28898,1698,2074,50131,262302
2005,Israel,ISR,-,-,0,0,0,0,0,0,0,0,0,0,6,0,0,6,624
2005,Italy,ITA,-,-,0,5,0,0,0,0,5,0,0,0,0,0,0,0,219
2005,Jamaica,JAM,-,-,0,0,0,0,0,0,0,0,0,0,0,0,0,0,489
2005,Jordan,JOR,-,-,6,0,5,5,0,17,33,0,5,0,15,0,11,31,1778
2005,Japan,JPN,-,-,0,0,0,0,0,0,0,0,0,0,0,0,0,0,10
2005,Kazakhstan,KAZ,-,-,7,0,5,13,0,152,177,6,0,0,89,0,121,216,4321
2005,Kenya,KEN,-,-,10,0,0,14,0,6,30,0,7,0,24,0,6,37,4638
2005,Kyrgyzstan,KGZ,-,-,0,5,0,0,0,47,52,0,5,5,0,0,45,55,3127
2005,Kiribati,KIR,-,-,0,0,0,0,0,0,0,0,0,0,0,0,0,0,31
2005,Rep. of Korea,KOR,-,-,0,0,0,0,0,0,0,0,0,0,0,0,0,0,266
2005,Dem. People's Rep. of Korea,PRK,-,-,0,0,0,0,0,0,0,0,0,0,0,0,0,0,287
2005,Kuwait,KWT,-,-,0,0,0,0,0,0,0,0,0,0,0,0,0,0,374
2005,Lao People's Dem. Rep.,LAO,-,-,21,23,19,555,5,3805,4428,38,26,23,748,25,4051,4911,24441
2005,Liberia,LBR,-,-,13809,20065,17194,50331,3279,58,104736,14288,19377,16631,43377,2199,146,96018,231136
2005,Libya,LBY,-,-,0,5,0,0,0,176,181,0,0,5,5,0,237,247,1556
2005,Saint Lucia,LCA,-,-,0,0,0,0,0,0,0,0,0,0,0,0,0,0,96
2005,Lebanon,LBN,-,-,0,6,0,20,5,28,59,0,0,5,34,0,78,117,18325
2005,Sri Lanka,LKA,-,-,109,139,124,592,134,5967,7065,112,155,128,679,50,10189,11313,108132
2005,Lithuania,LTU,-,-,0,0,0,0,0,0,0,0,0,0,0,0,12,12,1440
2005,Latvia,LVA,-,-,0,0,0,0,0,27,27,0,0,0,5,0,19,24,2428
2005,"China, Macao SAR",MAC,-,-,0,0,0,0,0,0,0,0,0,0,0,0,0,0,8
2005,Madagascar,MDG,-,-,0,0,0,0,0,81,81,0,0,0,5,0,86,91,201
2005,Mauritania,MRT,-,-,3153,3629,3107,3898,680,576,15043,1911,2985,2559,3474,520,3195,14644,31650
2005,North Macedonia,MKD,-,-,11,76,64,221,11,84,467,10,75,65,171,44,100,465,8603
2005,Rep. of Moldova,MDA,-,-,5,0,0,6,0,146,157,0,0,0,0,0,149,149,12065
2005,Maldives,MDV,-,-,0,0,0,0,0,0,0,0,0,0,0,0,5,5,10
2005,Mexico,MEX,-,-,0,0,0,0,0,0,0,0,0,0,0,0,0,0,2309
2005,Mali,MLI,-,-,0,0,0,14,0,42,56,0,14,0,14,0,87,115,512
2005,Malaysia,MYS,-,-,0,0,0,0,0,0,0,0,0,0,0,0,0,0,388
2005,Malawi,MWI,-,-,0,0,0,0,0,0,0,0,0,0,0,0,0,0,98
2005,Mongolia,MNG,-,-,0,0,0,8,0,69,77,0,5,0,6,0,48,59,655
2005,Morocco,MAR,-,-,0,0,5,5,0,30,40,0,7,0,5,0,68,80,2914
2005,Mozambique,MOZ,-,-,0,0,0,0,0,5,5,5,0,0,0,0,8,13,93
2005,Mauritius,MUS,-,-,0,0,0,0,0,0,0,0,0,0,0,0,5,5,22
2005,Myanmar,MMR,-,-,11137,13783,11815,33911,2540,105,73291,11751,14374,12319,39094,2563,240,80341,164851
2005,Namibia,NAM,-,-,45,49,42,164,5,0,305,74,48,42,695,11,0,870,1221
2005,Nepal,NPL,-,-,0,0,0,5,0,5,10,0,0,0,60,0,21,81,2061
2005,Netherlands,NLD,-,-,0,0,0,0,0,0,0,0,0,0,0,0,0,0,155
2005,Niger,NER,-,-,0,5,0,0,0,11,16,0,0,0,0,0,17,17,642
2005,Nicaragua,NIC,-,-,0,9,12,260,43,0,324,0,12,18,252,36,0,318,1463
2005,Nigeria,NGA,-,-,651,1230,1055,2248,88,133,5405,720,1176,1002,1837,163,238,5136,22123
2005,Norway,NOR,-,-,0,0,0,0,0,0,0,0,0,0,0,0,0,0,12
2005,New Zealand,NZL,-,-,0,0,0,0,0,0,0,0,0,0,0,0,0,0,5
2005,Oman,OMN,-,-,0,0,0,0,0,0,0,0,0,0,0,0,0,0,10
2005,Pakistan,PAK,-,-,19,11,10,79,0,92,211,16,33,28,155,0,231,463,29906
2005,Panama,PAN,-,-,0,0,0,0,0,0,0,0,0,0,0,0,0,0,41
2005,Paraguay,PRY,-,-,0,0,0,0,0,0,0,0,0,0,0,0,0,0,42
2005,Peru,PER,-,-,10,50,43,401,19,122,645,17,63,56,510,25,166,837,4863
2005,Philippines,PHL,-,-,0,0,0,0,0,0,0,0,0,0,5,0,0,5,464
2005,Papua New Guinea,PNG,-,-,0,0,0,0,0,0,0,0,0,0,0,0,0,0,20
2005,Poland,POL,-,-,0,0,0,0,5,105,110,0,0,0,5,5,84,94,19642
2005,Portugal,PRT,-,-,0,0,0,0,0,0,0,0,0,0,0,0,6,6,74
2005,Qatar,QAT,-,-,0,0,0,0,0,0,0,0,0,0,0,0,0,0,6
2005,Romania,ROU,-,-,0,0,0,10,7,68,85,5,0,0,5,0,68,78,11495
2005,South Africa,ZAF,-,-,5,0,0,0,0,5,10,5,0,0,0,0,10,15,259
2005,Russian Federation,RUS,-,-,363,517,446,1624,67,2763,5780,471,531,470,1352,56,2650,5530,103037
2005,Rwanda,RWA,-,-,3379,2549,2207,7690,192,3516,19533,3202,2643,2283,9627,293,3264,21312,100252
2005,El Salvador,SLV,-,-,0,125,107,864,142,5,1243,0,149,127,1110,131,10,1527,4283
2005,Saudi Arabia,SAU,-,-,0,0,0,5,0,0,5,0,0,0,0,0,0,0,146
2005,Serbia and Kosovo: S/RES/1244 (1999),SRB,-,-,473,1124,983,3402,365,4513,10860,505,1248,1091,3210,319,5442,11815,189985
2005,Senegal,SEN,-,-,686,802,693,1501,113,36,3831,727,778,662,1260,169,96,3692,8662
2005,Seychelles,SYC,-,-,0,0,0,0,0,0,0,0,0,0,0,0,0,0,39
2005,Singapore,SGP,-,-,0,0,0,0,0,0,0,0,0,0,0,0,0,0,35
2005,Sierra Leone,SLE,-,-,511,1013,864,3520,81,96,6085,609,1036,908,4505,118,236,7412,40473
2005,Solomon Islands,SLB,-,-,0,0,0,0,0,0,0,0,0,0,0,0,0,0,27
2005,Somalia,SOM,-,-,14454,21097,18055,62633,3461,439,120139,15458,22956,19673,81634,3818,605,144144,395544
2005,Spain,ESP,-,-,0,0,0,0,0,0,0,0,0,0,0,0,0,0,49
2005,Viet Nam,VNM,-,-,8380,16344,14021,85056,20256,6212,150269,11385,18576,15921,91634,19630,7785,164931,358268
2005,Saint Kitts and Nevis,KNA,-,-,0,0,0,0,0,0,0,0,0,0,0,0,0,0,31
2005,Sao Tome and Principe,STP,-,-,0,0,9,0,0,0,9,0,0,5,9,0,0,14,23
2005,Sudan,SDN,-,-,52370,56793,48702,122614,8960,22254,311693,53420,61206,52450,106297,5943,22948,302264,693621
2005,Suriname,SUR,-,-,0,0,0,0,0,0,0,0,0,0,0,0,0,0,26
2005,Slovakia,SVK,-,-,0,0,0,0,0,54,54,0,0,0,0,0,47,47,787
2005,Slovenia,SVN,-,-,0,0,0,0,0,0,0,0,0,0,0,0,0,0,154
2005,Eswatini,SWZ,-,-,0,0,0,0,0,0,0,0,0,0,0,0,0,0,12
2005,Sweden,SWE,-,-,0,0,0,0,0,0,0,0,0,0,0,0,0,0,75
2005,Switzerland,CHE,-,-,0,0,0,0,0,0,0,0,0,0,0,0,0,0,14
2005,Syrian Arab Rep.,SYR,-,-,34,66,71,256,22,111,560,49,63,56,332,44,258,802,16395
2005,United Rep. of Tanzania,TZA,-,-,0,0,5,0,0,0,5,0,5,0,0,0,0,5,1542
2005,Thailand,THA,-,-,5,9,8,17,0,0,39,7,0,5,31,5,0,48,424
2005,Tajikistan,TJK,-,-,8371,3500,2984,10693,2384,11,27943,7242,3157,2722,9636,2046,14,24817,54753
2005,Turkmenistan,TKM,-,-,0,0,0,0,0,0,0,0,0,0,0,0,5,5,818
2005,Timor-Leste,TLS,-,-,0,0,0,0,0,0,0,0,0,0,0,0,0,0,251
2005,Togo,TGO,-,-,2771,2908,2502,10858,773,189,20001,2837,2950,2546,12445,364,430,21572,51092
2005,Trinidad and Tobago,TTO,-,-,0,0,0,0,0,0,0,0,0,0,0,0,0,0,61
2005,Tunisia,TUN,-,-,0,0,5,5,0,301,311,5,0,0,18,0,671,694,3120
2005,Türkiye,TUR,-,-,404,1141,979,2570,302,4783,10179,451,1185,1014,2365,250,9676,14941,170557
2005,United Arab Emirates,ARE,-,-,0,0,0,0,0,0,0,0,0,0,0,0,0,0,31
2005,Uganda,UGA,-,-,224,477,400,1069,199,23,2392,254,560,503,1171,226,41,2755,34208
2005,Ukraine,UKR,-,-,0,0,6,18,0,355,379,0,0,0,17,0,313,330,84223
2005,Uruguay,URY,-,-,0,0,0,0,0,0,0,0,0,0,0,0,0,0,107
2005,United States of America,USA,-,-,0,0,0,0,0,0,0,0,0,0,0,0,0,0,676
2005,Uzbekistan,UZB,-,-,0,19,16,70,0,104,209,8,8,24,341,0,72,453,8322
2005,Saint Vincent and the Grenadines,VCT,-,-,0,0,0,0,0,0,0,0,0,0,0,0,0,0,279
2005,Venezuela (Bolivarian Republic of),VEN,-,-,0,8,0,0,0,0,8,0,0,0,9,0,0,9,2581
2005,Western Sahara,ESH,-,-,8418,8602,7374,13733,5947,0,44074,8397,9475,8121,14625,5949,9,46576,90650
2005,Yemen,YEM,-,-,5,29,31,96,5,31,197,5,25,27,114,6,32,209,1322
2005,Zambia,ZMB,-,-,0,0,0,0,0,0,0,0,0,0,0,0,0,0,146
2005,Zimbabwe,ZWE,-,-,0,6,0,21,0,5,32,0,5,0,58,0,6,69,11246
2005,Stateless,XXA,-,-,0,5,13,17,0,16,51,0,8,8,50,0,41,107,12280
2005,Tibetan,TIB,-,-,0,0,0,0,0,9610,9610,0,0,0,0,0,10543,10543,20198
2005,Unknown ,,-,-,251,280,209,671,28,633,2072,297,302,250,1071,52,849,2821,187212
2006,Afghanistan,AFG,-,-,32671,112288,9243,206019,12222,522238,894681,34858,121770,91026,285991,20484,527062,1081191,2107510
2006,Albania,ALB,-,-,0,0,0,13,0,690,703,0,0,0,6,0,806,812,14079
2006,Algeria,DZA,-,-,0,0,23,20,9,545,597,0,10,8,93,0,950,1061,8338
2006,Andorra,AND,-,-,0,0,0,0,0,0,0,0,0,0,0,0,0,0,10
2006,Angola,AGO,-,-,10453,20956,2871,36333,5255,2650,78518,9681,21555,2375,29376,4741,3934,71662,206482
2006,Antigua and Barbuda,ATG,-,-,0,0,0,0,0,0,0,0,0,0,0,0,0,0,18
2006,Egypt,EGY,-,-,0,0,6,11,0,55,72,0,0,0,22,0,96,118,7608
2006,Argentina,ARG,-,-,0,0,0,0,0,5,5,0,0,0,0,0,6,6,888
2006,Armenia,ARM,-,-,0,0,5,38,5,913,961,0,0,12,52,0,917,981,14913
2006,Australia,AUS,-,-,0,0,0,0,0,0,0,0,0,0,0,0,0,0,29
2006,Austria,AUT,-,-,0,0,0,0,0,0,0,0,0,0,0,0,0,0,30
2006,Azerbaijan,AZE,-,-,0,10,8,632,184,57712,58546,0,0,21,638,96,55474,56229,126068
2006,Bahrain,BHR,-,-,0,0,0,0,0,0,0,0,0,0,0,0,0,0,56
2006,Barbados,BRB,-,-,0,0,0,0,0,0,0,0,0,0,0,0,0,0,28
2006,Burundi,BDI,-,-,24182,26054,34889,80731,2712,588,169156,27017,29744,46377,91122,3104,646,198010,396533
2006,Belgium,BEL,-,-,0,0,0,0,0,0,0,0,0,0,0,0,0,0,63
2006,Benin,BEN,-,-,0,0,0,0,0,6,6,0,0,0,0,0,9,9,207
2006,Bangladesh,BGD,-,-,0,0,0,0,0,180,180,0,0,0,25,0,1160,1185,7796
2006,Bahamas,BHS,-,-,0,0,0,0,0,0,0,0,0,0,0,0,0,0,12
2006,Bhutan,BTN,-,-,3698,7369,7330,31151,3215,5,52768,4158,7883,7393,31822,3784,15,55055,108069
2006,Burkina Faso,BFA,-,-,0,0,0,0,0,14,14,0,0,0,0,0,34,34,373
2006,Belarus,BLR,-,-,0,0,5,0,0,242,247,0,0,0,5,0,297,302,9368
2006,Bolivia (Plurinational State of),BOL,-,-,0,0,0,0,0,18,18,0,0,0,0,0,26,26,371
2006,Botswana,BWA,-,-,0,0,0,0,0,0,0,0,0,0,0,0,0,0,10
2006,Brazil,BRA,-,-,0,0,0,0,0,0,0,0,0,0,0,0,12,12,703
2006,Bosnia and Herzegovina,BIH,-,-,130,774,1290,10814,5885,4731,23624,123,850,1398,10211,3220,4635,20437,199948
2006,Bulgaria,BGR,-,-,0,0,0,10,0,53,63,0,0,0,0,0,78,78,3431
2006,Belize,BLZ,-,-,0,0,0,0,0,0,0,0,0,0,0,0,0,0,13
2006,Cambodia,KHM,-,-,0,7,16,56,5,8401,8485,10,7,6,63,12,8123,8221,17963
2006,Canada,CAN,-,-,0,0,0,0,0,0,0,0,0,0,0,0,0,0,94
2006,Central African Rep.,CAF,-,-,5894,10037,5029,14163,699,209,36031,5825,10069,4828,10913,861,264,32760,71669
2006,Chad,TCD,-,-,148,395,714,2722,35,12710,16724,179,381,738,4143,103,13142,18686,36286
2006,China,CHN,-,-,9,6,16,59,6,656,752,6,0,0,69,5,1012,1092,140584
2006,Chile,CHL,-,-,0,0,5,9,0,84,98,0,0,8,0,0,111,119,798
2006,Cameroon,CMR,-,-,0,5,0,13,0,221,239,0,5,0,93,0,421,519,10373
2006,Congo,COG,-,-,546,808,596,2359,67,1367,5743,542,819,533,3068,70,1430,6462,20599
2006,Dem. Rep. of the Congo,COD,-,-,30230,31993,33931,71928,4206,7606,179894,29467,31016,34214,60735,3212,8501,167145,401908
2006,Comoros,COM,-,-,0,0,0,0,0,9,9,0,0,0,0,0,29,29,73
2006,Colombia,COL,-,-,132,214,234,838,42,479,1939,148,224,217,987,55,582,2213,72793
2006,Costa Rica,CRI,-,-,0,0,0,0,0,0,0,5,0,0,0,0,0,5,283
2006,Cuba,CUB,-,-,0,18,27,340,17,105,507,9,28,31,587,32,168,855,33580
2006,Cabo Verde,CPV,-,-,0,0,0,0,0,0,0,0,0,0,0,0,0,0,34
2006,Cyprus,CYP,-,-,0,0,0,0,0,0,0,0,0,0,0,0,0,0,5
2006,Czechia,CZE,-,-,0,0,0,0,0,17,17,0,0,0,0,5,27,32,2136
2006,Denmark,DNK,-,-,0,0,0,0,0,0,0,0,0,0,0,0,0,0,10
2006,Djibouti,DJI,-,-,0,7,0,14,0,74,95,9,0,0,27,0,76,112,479
2006,Dominica,DMA,-,-,0,0,0,0,0,0,0,0,0,0,0,0,0,0,49
2006,Dominican Rep.,DOM,-,-,0,0,0,0,0,0,0,0,0,0,0,0,0,0,141
2006,Ecuador,ECU,-,-,0,8,0,0,0,25,33,0,0,0,0,0,29,29,878
2006,Equatorial Guinea,GNQ,-,-,0,8,0,28,0,13,49,0,14,11,22,0,17,64,460
2006,Eritrea,ERI,-,-,4913,8822,7451,26616,3999,32051,83852,5252,7982,6798,32662,4057,32092,88843,193738
2006,Estonia,EST,-,-,0,0,0,0,0,5,5,0,0,0,0,0,10,10,622
2006,Ethiopia,ETH,-,-,759,883,662,4648,42,5861,12855,837,1020,911,10049,226,5836,18879,74007
2006,Fiji,FJI,-,-,0,0,0,0,0,0,0,0,0,0,0,0,0,0,1681
2006,Finland,FIN,-,-,0,0,0,0,0,0,0,0,0,0,0,0,0,0,10
2006,France,FRA,-,-,0,0,0,0,0,0,0,0,0,0,0,0,0,0,79
2006,Gabon,GAB,-,-,0,0,0,0,0,5,5,0,0,0,0,0,12,12,96
2006,Gambia,GMB,-,-,0,0,0,0,0,17,17,0,0,0,14,0,44,58,1249
2006,Palestinian,PSE,-,-,6617,9219,6230,18034,1504,85,41689,7353,6393,11368,19706,1321,191,46332,334127
2006,United Kingdom of Great Britain and Northern Ireland,GBR,-,-,0,0,0,0,0,0,0,0,0,0,0,0,0,0,170
2006,Georgia,GEO,-,-,0,0,5,56,0,1002,1063,0,5,5,60,0,907,977,6337
2006,Germany,DEU,-,-,0,0,0,0,0,10,10,0,0,0,0,0,5,5,114
2006,Ghana,GHA,-,-,5,0,15,26,0,236,282,0,0,17,51,5,379,452,9949
2006,Guinea-Bissau,GNB,-,-,0,0,0,0,0,252,252,0,0,0,5,0,617,622,1000
2006,Greece,GRC,-,-,0,0,0,0,0,0,0,0,0,0,0,0,0,0,93
2006,Grenada,GRD,-,-,0,0,0,0,0,0,0,0,0,0,0,0,0,0,199
2006,Guatemala,GTM,-,-,0,0,34,407,38,5,484,0,5,6,186,565,20,782,6493
2006,Guinea,GIN,-,-,0,8,0,17,0,537,562,0,0,12,54,0,884,950,6830
2006,Guyana,GUY,-,-,0,0,0,0,0,0,0,0,0,0,0,0,0,0,535
2006,Haiti,HTI,-,-,0,6,5,24,0,1127,1162,0,0,5,58,0,1583,1646,20834
2006,"China, Hong Kong SAR",HKG,-,-,0,0,0,0,0,0,0,0,0,0,0,0,0,0,8
2006,Honduras,HND,-,-,0,0,0,24,0,0,24,0,0,5,30,0,0,35,1035
2006,Croatia,HRV,-,-,298,1848,2654,22503,13128,167,40598,280,1972,2856,26688,7895,179,39870,93768
2006,Hungary,HUN,-,-,0,0,0,0,0,32,32,0,0,0,5,11,120,136,3117
2006,Iceland,ISL,-,-,0,0,0,0,0,0,0,0,0,0,0,0,0,0,32
2006,Cote d'Ivoire,CIV,-,-,620,1019,906,6492,192,460,9689,609,1010,983,7924,238,1108,11872,26304
2006,India,IND,-,-,0,0,0,5,0,49,54,0,0,0,23,0,212,235,17797
2006,Indonesia,IDN,-,-,618,160,174,2437,7,1310,4706,575,100,301,10741,61,1372,13150,34722
2006,Ireland,IRL,-,-,0,0,0,0,0,0,0,0,0,0,0,0,0,0,5
2006,Iran (Islamic Rep. of),IRN,-,-,528,1286,1091,3657,283,1367,8212,556,1283,1264,4261,303,2210,9877,102479
2006,Iraq,IRQ,-,-,3853,9932,3460,23955,1648,2398,45246,4082,10615,8662,32246,2209,4431,62245,1450908
2006,Israel,ISR,-,-,0,0,0,5,0,5,10,0,0,0,0,0,0,0,876
2006,Italy,ITA,-,-,0,0,0,0,0,5,5,0,0,0,0,0,0,0,106
2006,Jamaica,JAM,-,-,0,0,0,0,0,0,0,0,0,0,0,0,0,0,661
2006,Jordan,JOR,-,-,7,8,0,0,0,19,34,0,0,0,19,0,18,37,1592
2006,Japan,JPN,-,-,0,0,0,0,0,0,0,0,0,0,0,0,0,0,166
2006,Kazakhstan,KAZ,-,-,0,0,0,8,0,201,209,0,0,5,83,0,155,243,7374
2006,Kenya,KEN,-,-,15,0,6,5,0,15,41,5,0,12,11,0,15,43,5356
2006,Kyrgyzstan,KGZ,-,-,0,0,5,0,0,77,82,0,5,5,0,0,74,84,2493
2006,Kiribati,KIR,-,-,0,0,0,0,0,0,0,0,0,0,0,0,0,0,39
2006,Rep. of Korea,KOR,-,-,0,0,0,0,0,0,0,0,0,0,0,0,6,6,1333
2006,Dem. People's Rep. of Korea,PRK,-,-,0,0,0,0,0,0,0,0,0,0,0,0,6,6,394
2006,Kuwait,KWT,-,-,0,0,0,0,0,0,0,0,0,0,9,0,0,9,610
2006,Lao People's Dem. Rep.,LAO,-,-,27,54,33,588,5,3767,4474,56,45,50,803,26,4044,5024,26445
2006,Liberia,LBR,-,-,5668,12855,9540,31659,1713,89,61524,6000,10629,9005,30119,1250,415,57418,160543
2006,Libya,LBY,-,-,0,0,0,0,0,168,168,0,6,0,5,0,230,241,1557
2006,Saint Lucia,LCA,-,-,0,0,0,0,0,0,0,0,0,0,0,0,0,0,163
2006,Lebanon,LBN,-,-,0,0,5,11,0,47,63,0,0,0,23,0,126,149,12249
2006,Lesotho,LSO,-,-,0,0,0,0,0,0,0,0,0,0,0,0,0,0,5
2006,Sri Lanka,LKA,-,-,0,16,14,22,0,40811,40863,0,0,16,144,0,46837,46997,116948
2006,Lithuania,LTU,-,-,0,0,0,0,0,11,11,0,0,0,0,0,23,23,936
2006,Latvia,LVA,-,-,0,0,0,0,0,42,42,0,0,0,5,0,27,32,1424
2006,"China, Macao SAR",MAC,-,-,0,0,0,0,0,0,0,0,0,0,0,0,0,0,8
2006,Madagascar,MDG,-,-,0,0,0,0,0,97,97,0,0,0,0,0,107,107,258
2006,Mauritania,MRT,-,-,3150,3718,3006,3874,680,643,15071,1907,2729,2799,3441,520,3358,14754,33420
2006,North Macedonia,MKD,-,-,5,32,32,114,9,171,363,7,38,39,108,14,200,406,7937
2006,Rep. of Moldova,MDA,-,-,0,0,0,0,0,188,188,0,5,0,0,0,174,179,11680
2006,Maldives,MDV,-,-,0,0,0,0,0,0,0,0,0,0,0,0,5,5,15
2006,Mexico,MEX,-,-,0,0,0,0,0,0,0,0,0,0,0,0,5,5,3301
2006,Mali,MLI,-,-,0,0,0,5,0,72,77,0,5,9,14,0,103,131,586
2006,Malaysia,MYS,-,-,0,0,0,0,0,0,0,0,0,0,0,0,0,0,575
2006,Malawi,MWI,-,-,0,0,0,0,0,0,0,0,0,0,0,0,0,0,112
2006,Mongolia,MNG,-,-,0,0,0,0,0,126,126,0,0,0,0,0,94,94,866
2006,Morocco,MAR,-,-,0,0,0,0,0,40,40,0,7,0,0,0,89,96,4699
2006,Mozambique,MOZ,-,-,0,0,0,0,0,5,5,0,0,0,0,0,13,13,216
2006,Malta,MLT,-,-,0,0,0,0,0,0,0,0,0,0,0,0,0,0,25
2006,Montenegro,MNE,-,-,0,0,0,0,0,0,0,0,0,0,0,0,0,0,136
2006,Mauritius,MUS,-,-,0,0,0,0,0,0,0,0,0,0,0,0,5,5,75
2006,Myanmar,MMR,-,-,12428,16119,13110,41127,3043,103,85930,13096,16670,13760,49637,2964,300,96427,202817
2006,Namibia,NAM,-,-,0,0,0,0,0,0,0,0,0,0,0,0,0,0,1196
2006,Nepal,NPL,-,-,5,0,0,15,0,16,36,0,5,5,70,0,47,127,2651
2006,Netherlands,NLD,-,-,0,0,0,0,0,0,0,0,0,0,0,0,0,0,41
2006,Niger,NER,-,-,0,0,0,0,0,17,17,0,0,0,0,0,33,33,803
2006,Nicaragua,NIC,-,-,0,0,14,239,43,0,296,0,0,11,252,34,0,297,1827
2006,Nigeria,NGA,-,-,274,405,254,776,29,211,1949,331,388,242,599,56,332,1948,13242
2006,New Zealand,NZL,-,-,0,0,0,0,0,0,0,0,0,0,0,0,0,0,7
2006,Oman,OMN,-,-,0,0,0,0,0,0,0,0,0,0,0,0,0,0,37
2006,Pakistan,PAK,-,-,23,25,13,87,5,168,321,24,31,13,209,5,357,639,25636
2006,Panama,PAN,-,-,0,0,0,0,0,0,0,0,0,0,0,0,0,0,72
2006,Paraguay,PRY,-,-,0,0,0,0,0,0,0,0,0,0,0,0,7,7,103
2006,Peru,PER,-,-,11,48,54,357,24,134,628,12,71,57,427,20,192,779,6977
2006,Philippines,PHL,-,-,0,0,0,0,0,0,0,0,0,0,5,0,0,5,888
2006,Papua New Guinea,PNG,-,-,0,0,0,0,0,0,0,0,0,0,0,0,0,0,27
2006,Poland,POL,-,-,0,0,0,0,0,295,295,0,0,0,5,5,336,346,13508
2006,Portugal,PRT,-,-,0,0,0,0,0,0,0,0,0,0,0,0,6,6,25
2006,Qatar,QAT,-,-,0,0,0,0,0,0,0,0,0,0,0,0,0,0,48
2006,Romania,ROU,-,-,0,0,0,0,7,145,152,0,0,0,0,0,156,156,7224
2006,South Africa,ZAF,-,-,0,0,0,0,0,5,5,0,0,0,0,0,23,23,501
2006,Russian Federation,RUS,-,-,364,342,927,2196,101,5887,9817,418,416,979,1924,82,6051,9870,159383
2006,Rwanda,RWA,-,-,2777,3112,2166,8356,231,2440,19082,2638,3170,2312,9934,321,2150,20525,92956
2006,El Salvador,SLV,-,-,0,0,145,871,141,5,1162,0,0,172,1124,159,15,1470,6390
2006,Saudi Arabia,SAU,-,-,0,0,0,0,0,0,0,0,0,0,0,0,0,0,609
2006,Serbia and Kosovo: S/RES/1244 (1999),SRB,-,-,212,312,342,1324,187,8941,11318,215,344,396,1294,216,9935,12400,174022
2006,Senegal,SEN,-,-,1225,2274,2564,1323,352,47,7785,1257,1318,1620,2089,444,102,6830,15150
2006,Seychelles,SYC,-,-,0,0,0,0,0,0,0,0,0,0,0,0,0,0,61
2006,Singapore,SGP,-,-,0,0,0,0,0,0,0,0,0,0,0,0,0,0,108
2006,Sierra Leone,SLE,-,-,1020,1536,1733,4610,288,142,9329,1105,1542,1716,5430,282,384,10459,42849
2006,Solomon Islands,SLB,-,-,0,0,0,0,0,0,0,0,0,0,0,0,0,0,37
2006,Somalia,SOM,-,-,15434,24119,18902,70826,3943,1997,135221,16225,25777,21597,98171,4522,2295,168587,464026
2006,Spain,ESP,-,-,0,0,0,0,0,0,0,0,0,0,0,0,5,5,2442
2006,Viet Nam,VNM,-,-,6,12,24,76,13,5966,6097,9,9,37,108,12,7767,7942,374278
2006,Sao Tome and Principe,STP,-,-,0,0,9,5,0,0,14,0,0,5,11,0,0,16,30
2006,Sudan,SDN,-,-,48029,69517,38469,121888,9070,257,287230,49250,69736,45536,103749,6399,852,275522,686296
2006,Suriname,SUR,-,-,0,0,0,0,0,0,0,0,0,0,0,0,0,0,65
2006,Slovakia,SVK,-,-,0,0,0,0,0,54,54,0,0,0,0,0,48,48,741
2006,Slovenia,SVN,-,-,0,0,0,0,0,0,0,0,0,0,0,0,0,0,1757
2006,Eswatini,SWZ,-,-,0,0,0,0,0,0,0,0,0,0,0,0,0,0,16
2006,Sweden,SWE,-,-,0,0,0,0,0,0,0,0,0,0,0,0,0,0,16
2006,Switzerland,CHE,-,-,0,0,0,0,0,0,0,0,0,0,0,0,0,0,38
2006,Syrian Arab Rep.,SYR,-,-,28,78,75,220,19,229,649,33,74,51,244,39,567,1008,12327
2006,United Rep. of Tanzania,TZA,-,-,0,0,0,0,0,5,5,0,0,5,7,0,10,22,1665
2006,Thailand,THA,-,-,6,7,14,25,0,0,52,5,0,12,48,5,0,70,3323
2006,Tajikistan,TJK,-,-,0,5,5,23,0,12,45,0,5,0,6,0,15,26,646
2006,Turkmenistan,TKM,-,-,0,0,5,0,0,0,5,0,0,0,5,0,8,13,689
2006,Timor-Leste,TLS,-,-,0,0,0,0,0,0,0,0,0,0,0,0,0,0,251
2006,Togo,TGO,-,-,1314,1063,1355,4627,241,322,8922,1343,1079,1331,5688,127,633,10201,27318
2006,Tonga,TON,-,-,0,0,0,0,0,0,0,0,0,0,0,0,0,0,5
2006,Trinidad and Tobago,TTO,-,-,0,0,0,0,0,0,0,0,0,0,0,0,0,0,151
2006,Tunisia,TUN,-,-,0,0,11,0,0,334,345,10,0,0,10,0,702,722,2835
2006,Türkiye,TUR,-,-,1045,1756,1437,3902,370,5406,13916,1129,1753,1479,3691,339,10699,19090,227236
2006,Tuvalu,TUV,-,-,0,0,0,0,0,0,0,0,0,0,0,0,0,0,5
2006,United Arab Emirates,ARE,-,-,0,0,0,0,0,0,0,0,0,0,0,0,0,0,260
2006,Uganda,UGA,-,-,1982,2386,100,2620,1448,22,8558,1879,2319,226,2366,1538,47,8375,21735
2006,Ukraine,UKR,-,-,0,0,0,11,0,447,458,0,0,0,12,0,384,396,63716
2006,Uruguay,URY,-,-,0,0,0,0,0,5,5,0,0,0,0,0,0,0,158
2006,United States of America,USA,-,-,0,0,0,0,0,0,0,0,0,0,0,0,0,0,1353
2006,Uzbekistan,UZB,-,-,16,27,15,52,0,136,246,24,29,11,90,0,98,252,9095
2006,Saint Vincent and the Grenadines,VCT,-,-,0,0,0,0,0,0,0,0,0,0,0,0,0,0,386
2006,Venezuela (Bolivarian Republic of),VEN,-,-,0,7,0,0,0,0,7,0,0,0,7,0,0,7,3821
2006,Western Sahara,ESH,-,-,0,0,0,0,0,0,0,0,0,94,501,0,16,611,90611
2006,Yemen,YEM,-,-,0,15,22,100,5,48,190,0,17,18,115,10,66,226,1364
2006,Zambia,ZMB,-,-,0,0,0,0,0,0,0,0,0,0,0,0,0,0,199
2006,Zimbabwe,ZWE,-,-,0,0,0,0,0,10,10,0,0,0,0,0,8,8,12774
2006,Stateless,XXA,-,-,0,0,21,20,0,12,53,0,9,9,49,0,39,106,11255
2006,Tibetan,TIB,-,-,0,0,0,0,0,9615,9615,0,0,0,0,0,10554,10554,20184
2006,Unknown ,,-,-,188,214,290,976,16,971,2655,150,234,318,938,24,1482,3146,246951
2007,Afghanistan,AFG,-,-,39774,110636,66046,188200,11080,398480,814216,41851,118508,79832,220835,21838,511097,993961,3057655
2007,Albania,ALB,-,-,0,0,12,18,0,697,727,0,7,6,18,0,794,825,15335
2007,Algeria,DZA,-,-,5,19,5,53,0,517,599,5,18,13,120,0,920,1076,10599
2007,Andorra,AND,-,-,0,0,0,0,0,0,0,0,0,0,0,0,0,0,10
2007,Angola,AGO,-,-,2874,2592,3058,7281,808,1156,17769,2253,2280,2656,7133,687,1765,16774,186137
2007,Antigua and Barbuda,ATG,-,-,0,0,0,0,0,0,0,0,0,0,0,0,0,0,24
2007,Egypt,EGY,-,-,0,0,5,23,0,47,75,0,0,7,18,0,95,120,6789
2007,Argentina,ARG,-,-,0,0,0,5,0,5,10,0,0,0,6,0,0,6,1164
2007,Armenia,ARM,-,-,0,6,15,71,5,999,1096,0,8,17,81,0,978,1084,15435
2007,Australia,AUS,-,-,0,0,0,0,0,0,0,0,0,0,0,0,0,0,57
2007,Austria,AUT,-,-,0,0,0,0,0,0,0,0,0,0,0,0,0,0,19
2007,Azerbaijan,AZE,-,-,0,10,0,1465,652,854,2981,0,5,10,1487,279,839,2620,15922
2007,Bahrain,BHR,-,-,0,0,0,0,0,0,0,0,0,0,0,0,0,0,65
2007,Barbados,BRB,-,-,0,0,0,0,0,0,0,0,0,0,0,0,0,0,39
2007,Burundi,BDI,-,-,32010,31076,33942,73876,4937,308,176149,31886,30929,33016,69049,5373,309,170562,375720
2007,Belgium,BEL,-,-,0,0,0,0,0,0,0,0,0,0,0,0,0,0,53
2007,Benin,BEN,-,-,0,0,0,0,0,18,18,0,5,0,0,0,7,12,265
2007,Bangladesh,BGD,-,-,0,6,0,16,0,179,201,0,7,0,36,0,1329,1372,10235
2007,Bahamas,BHS,-,-,0,0,0,0,0,0,0,0,0,0,0,0,0,0,14
2007,Bhutan,BTN,-,-,3992,6647,6742,31119,3393,1227,53120,4212,6949,6910,31471,3932,1244,54718,110593
2007,Burkina Faso,BFA,-,-,5,0,0,0,0,19,24,0,5,0,5,0,32,42,557
2007,Belarus,BLR,-,-,0,5,5,5,0,240,255,0,0,7,15,0,310,332,4961
2007,Bolivia (Plurinational State of),BOL,-,-,0,10,0,0,0,18,28,0,0,0,0,0,27,27,423
2007,Botswana,BWA,-,-,0,0,0,0,0,0,0,0,0,0,0,0,0,0,16
2007,Brazil,BRA,-,-,0,0,0,0,0,9,9,0,0,0,0,0,5,5,1623
2007,Bosnia and Herzegovina,BIH,-,-,111,799,1336,11453,6253,3505,23457,104,873,1440,10731,3454,3654,20256,78267
2007,Bulgaria,BGR,-,-,0,0,0,24,0,54,78,0,0,0,13,0,77,90,3306
2007,Belize,BLZ,-,-,0,0,0,0,0,0,0,0,0,0,0,0,0,0,13
2007,Cambodia,KHM,-,-,5,0,12,39,5,8318,8379,0,6,5,47,11,8025,8094,17700
2007,Canada,CAN,-,-,0,0,0,0,0,0,0,0,0,0,0,0,0,0,530
2007,Central African Rep.,CAF,-,-,4272,6569,3287,10494,425,1473,26520,4243,6854,2885,8731,842,1534,25089,98092
2007,Chad,TCD,-,-,133,385,579,2409,40,22732,26278,165,352,597,3848,102,23189,28253,55697
2007,China,CHN,-,-,21,41,39,270,8,524,903,34,36,25,378,7,847,1327,149087
2007,Chile,CHL,-,-,0,0,5,23,0,79,107,0,0,8,19,0,88,115,964
2007,Cameroon,CMR,-,-,7,10,0,36,0,226,279,5,5,0,114,0,461,585,11499
2007,Congo,COG,-,-,397,744,601,2212,76,1419,5449,430,701,513,2869,70,1471,6054,19726
2007,Dem. Rep. of the Congo,COD,-,-,26695,28883,29645,62958,3473,6112,157766,25958,28971,28867,57153,2930,6896,150775,370372
2007,Comoros,COM,-,-,0,0,0,0,0,11,11,0,0,0,0,0,44,44,93
2007,Colombia,COL,-,-,602,1854,1559,8290,313,287,12905,799,2027,1869,10256,642,368,15961,551741
2007,Costa Rica,CRI,-,-,0,0,0,0,0,0,0,5,0,0,0,0,0,5,361
2007,Cuba,CUB,-,-,12,40,71,584,35,82,824,22,61,95,1011,66,91,1346,7496
2007,Cabo Verde,CPV,-,-,0,0,0,0,0,0,0,0,0,0,0,0,0,0,28
2007,Cyprus,CYP,-,-,0,0,0,5,0,0,5,0,0,0,0,0,0,0,10
2007,Czechia,CZE,-,-,0,0,0,0,0,11,11,0,0,0,0,5,16,21,1379
2007,Denmark,DNK,-,-,0,0,0,0,0,0,0,0,0,0,0,0,0,0,15
2007,Djibouti,DJI,-,-,0,7,0,10,5,59,81,11,0,0,27,0,69,107,645
2007,Dominica,DMA,-,-,0,0,0,0,0,0,0,0,0,0,0,0,0,0,58
2007,Dominican Rep.,DOM,-,-,0,0,5,0,0,0,5,0,0,0,6,0,0,6,352
2007,Ecuador,ECU,-,-,0,11,5,5,0,12,33,5,13,0,6,0,27,51,1329
2007,Equatorial Guinea,GNQ,-,-,0,10,5,30,0,13,58,0,13,5,25,0,17,60,402
2007,Eritrea,ERI,-,-,5772,9870,12007,34597,4391,20107,86744,5760,8212,11006,47838,4291,20288,97395,208747
2007,Estonia,EST,-,-,0,0,0,0,0,5,5,0,0,0,0,0,10,10,258
2007,Ethiopia,ETH,-,-,943,1114,1106,6519,89,4601,14372,965,1331,1294,12415,276,4289,20570,59845
2007,Fiji,FJI,-,-,0,0,0,0,0,0,0,0,0,0,0,0,0,0,1824
2007,Finland,FIN,-,-,0,0,0,0,0,0,0,0,0,0,0,0,0,0,5
2007,France,FRA,-,-,0,0,0,0,0,0,0,0,0,0,0,0,0,0,99
2007,Gabon,GAB,-,-,0,0,0,0,0,5,5,0,0,0,0,0,16,16,116
2007,Gambia,GMB,-,-,0,0,0,5,0,17,22,0,0,0,10,0,45,55,1257
2007,Palestinian,PSE,-,-,6787,9023,5853,15746,5041,52,42502,7529,6103,11035,20647,1391,122,46827,341231
2007,United Kingdom of Great Britain and Northern Ireland,GBR,-,-,0,0,0,0,0,0,0,0,0,0,0,0,0,0,198
2007,Georgia,GEO,-,-,6,5,5,86,5,1003,1110,0,12,7,101,0,886,1006,11805
2007,Germany,DEU,-,-,0,0,0,0,0,11,11,0,0,0,0,0,5,5,126
2007,Ghana,GHA,-,-,0,5,0,21,0,225,251,5,0,0,57,8,358,428,5042
2007,Guinea-Bissau,GNB,-,-,0,0,0,5,0,251,256,0,0,0,19,0,605,624,1018
2007,Greece,GRC,-,-,0,0,0,0,0,0,0,0,0,0,0,0,0,0,92
2007,Grenada,GRD,-,-,0,0,0,0,0,0,0,0,0,0,0,0,0,0,293
2007,Guatemala,GTM,-,-,0,0,5,120,12,5,142,0,5,7,135,23,20,190,6157
2007,Guinea,GIN,-,-,5,10,0,31,0,849,895,5,13,0,76,0,1110,1204,8269
2007,Guyana,GUY,-,-,0,0,0,0,0,0,0,0,0,0,0,0,0,0,676
2007,Haiti,HTI,-,-,6,6,11,53,0,1270,1346,0,5,12,95,0,1743,1855,22275
2007,"China, Hong Kong SAR",HKG,-,-,0,0,0,0,0,0,0,0,0,0,0,0,0,0,9
2007,Honduras,HND,-,-,0,0,0,12,0,21,33,0,0,6,32,0,38,76,1236
2007,Croatia,HRV,-,-,183,1564,2619,22257,13557,149,40329,167,1648,2792,26455,8316,146,39524,100429
2007,Hungary,HUN,-,-,0,0,0,0,0,29,29,0,0,0,5,11,118,134,3384
2007,Iceland,ISL,-,-,0,0,0,0,0,0,0,0,0,0,0,0,0,0,10
2007,Cote d'Ivoire,CIV,-,-,480,945,837,3988,165,599,7014,494,966,897,5730,201,1164,9452,22222
2007,India,IND,-,-,0,0,0,5,0,12,17,0,5,0,41,0,234,280,20455
2007,Indonesia,IDN,-,-,174,438,625,561,5,6,1809,175,479,689,1236,5,0,2584,20549
2007,Ireland,IRL,-,-,0,0,0,0,0,0,0,0,0,0,0,0,0,0,9
2007,Iran (Islamic Rep. of),IRN,-,-,368,1188,1022,3830,256,1008,7672,374,1214,1220,4574,340,1752,9474,68398
2007,Iraq,IRQ,-,-,86636,146403,124168,539168,57054,26754,980183,91307,158267,138478,635517,56135,34782,1114486,2309246
2007,Israel,ISR,-,-,0,0,0,11,0,5,16,0,0,0,7,0,0,7,1539
2007,Italy,ITA,-,-,0,0,0,0,0,0,0,0,0,0,0,0,0,0,84
2007,Jamaica,JAM,-,-,0,0,0,0,0,0,0,0,0,0,0,0,0,0,766
2007,Jordan,JOR,-,-,5,5,0,13,0,0,23,0,0,7,16,0,21,44,1777
2007,Japan,JPN,-,-,0,0,0,0,0,0,0,0,0,0,0,0,0,0,519
2007,Kazakhstan,KAZ,-,-,0,0,5,16,0,192,213,0,0,13,86,0,149,248,5232
2007,Kenya,KEN,-,-,256,11,573,511,84,10,1445,275,18,450,465,78,11,1297,7544
2007,Kyrgyzstan,KGZ,-,-,0,0,0,6,0,75,81,0,5,5,13,0,74,97,2257
2007,Kiribati,KIR,-,-,0,0,0,0,0,0,0,0,0,0,0,0,0,0,36
2007,Rep. of Korea,KOR,-,-,0,0,0,0,0,0,0,0,0,0,0,0,0,0,1183
2007,Dem. People's Rep. of Korea,PRK,-,-,0,0,0,0,0,0,0,0,0,0,11,0,0,11,602
2007,Kuwait,KWT,-,-,0,0,0,0,0,0,0,0,0,0,9,0,0,9,741
2007,Lao People's Dem. Rep.,LAO,-,-,34,56,39,600,5,3712,4446,56,57,51,824,28,4044,5060,10012
2007,Liberia,LBR,-,-,4333,8383,6124,22489,1023,66,42418,4435,7796,5937,20690,833,168,39859,91542
2007,Libya,LBY,-,-,5,0,0,5,0,124,134,0,5,0,11,0,192,208,1939
2007,Saint Lucia,LCA,-,-,0,0,0,0,0,0,0,0,0,0,0,0,0,0,227
2007,Lebanon,LBN,-,-,0,0,0,31,0,31,62,0,5,0,40,0,101,146,13089
2007,Lesotho,LSO,-,-,0,0,0,0,0,0,0,0,0,0,0,0,0,0,5
2007,Sri Lanka,LKA,-,-,82,144,92,509,143,42070,43040,69,172,98,855,49,48120,49363,134945
2007,Lithuania,LTU,-,-,0,0,0,0,0,11,11,0,0,0,0,0,25,25,461
2007,Latvia,LVA,-,-,0,0,0,5,0,32,37,0,0,0,5,0,20,25,660
2007,"China, Macao SAR",MAC,-,-,0,0,0,0,0,0,0,0,0,0,0,0,0,0,8
2007,Madagascar,MDG,-,-,0,0,0,0,0,106,106,0,0,0,5,0,116,121,282
2007,Mauritania,MRT,-,-,3139,3687,3006,3840,680,693,15045,1904,2711,2799,3408,519,3386,14727,33095
2007,North Macedonia,MKD,-,-,10,43,43,155,14,109,374,14,50,50,145,14,136,409,8072
2007,Rep. of Moldova,MDA,-,-,5,0,0,6,0,179,190,0,0,0,0,0,192,192,4913
2007,Maldives,MDV,-,-,0,0,0,0,0,0,0,0,0,0,0,0,5,5,15
2007,Mexico,MEX,-,-,0,0,0,0,0,0,0,0,0,0,7,0,0,7,5568
2007,Mali,MLI,-,-,0,0,0,13,0,241,254,0,5,9,19,0,137,170,4489
2007,Malaysia,MYS,-,-,0,0,0,0,0,0,0,0,0,0,0,0,0,0,611
2007,Malawi,MWI,-,-,0,0,0,0,0,0,0,0,0,0,0,0,0,0,93
2007,Mongolia,MNG,-,-,0,0,6,9,0,120,135,0,0,0,12,0,81,93,1103
2007,Morocco,MAR,-,-,0,0,5,11,0,35,51,7,0,0,5,0,89,101,4036
2007,Mozambique,MOZ,-,-,0,0,0,0,0,5,5,9,0,0,0,0,8,17,213
2007,Malta,MLT,-,-,0,0,0,0,0,0,0,0,0,0,0,0,0,0,10
2007,Montenegro,MNE,-,-,0,0,0,5,0,0,5,0,0,0,0,0,0,0,555
2007,Mauritius,MUS,-,-,0,0,0,0,0,0,0,0,0,0,0,0,5,5,67
2007,Myanmar,MMR,-,-,12110,16332,12100,41525,2993,144,85204,12941,16796,12932,52754,2951,369,98743,191308
2007,Namibia,NAM,-,-,51,63,32,118,5,0,269,71,66,23,658,5,0,823,1123
2007,Nepal,NPL,-,-,0,8,0,13,0,19,40,5,0,0,46,0,48,99,3364
2007,Netherlands,NLD,-,-,0,0,0,0,0,0,0,0,0,0,0,0,0,0,44
2007,Niger,NER,-,-,0,0,0,0,0,19,19,8,0,0,0,0,28,36,817
2007,Nicaragua,NIC,-,-,12,27,40,426,49,0,554,17,36,41,494,46,0,634,1899
2007,Nigeria,NGA,-,-,216,330,316,791,36,228,1917,263,359,274,677,61,326,1960,13898
2007,New Zealand,NZL,-,-,0,0,0,0,0,0,0,0,0,0,0,0,0,0,12
2007,Oman,OMN,-,-,0,0,0,0,0,0,0,0,0,0,0,0,0,0,44
2007,Pakistan,PAK,-,-,33,35,23,119,5,119,334,30,35,32,250,0,313,660,31847
2007,Panama,PAN,-,-,0,0,0,8,0,0,8,0,0,0,10,0,0,10,105
2007,Paraguay,PRY,-,-,0,0,0,0,0,0,0,0,0,0,7,0,0,7,99
2007,Peru,PER,-,-,11,64,93,549,24,117,858,24,82,76,688,27,165,1062,7738
2007,Philippines,PHL,-,-,0,0,0,0,0,0,0,0,0,0,5,0,0,5,1550
2007,Papua New Guinea,PNG,-,-,0,0,0,0,0,0,0,0,0,0,0,0,0,0,33
2007,Poland,POL,-,-,0,0,0,0,0,271,271,0,0,0,5,5,303,313,2911
2007,Portugal,PRT,-,-,0,0,0,0,0,0,0,0,0,0,0,0,7,7,29
2007,Qatar,QAT,-,-,0,0,0,0,0,0,0,0,0,0,0,0,0,0,57
2007,Romania,ROU,-,-,0,0,0,18,7,131,156,0,5,0,8,0,149,162,5299
2007,South Africa,ZAF,-,-,0,5,5,0,0,5,15,0,0,0,5,0,14,19,474
2007,Russian Federation,RUS,-,-,326,350,883,2145,104,6055,9863,408,386,929,1845,70,6226,9864,93218
2007,Rwanda,RWA,-,-,3131,3273,2510,8315,218,1943,19390,2921,3366,2577,10227,317,1667,21075,80955
2007,El Salvador,SLV,-,-,0,0,45,589,114,5,753,0,5,50,767,172,11,1005,6026
2007,Saudi Arabia,SAU,-,-,0,0,0,0,0,0,0,0,0,0,0,0,0,0,737
2007,Serbia and Kosovo: S/RES/1244 (1999),SRB,-,-,245,672,658,2069,249,3105,6998,302,749,726,1967,220,8484,12448,165636
2007,Senegal,SEN,-,-,1225,2279,2564,1576,352,50,8046,1257,1319,1620,2467,444,109,7216,15886
2007,Seychelles,SYC,-,-,0,0,0,0,0,0,0,0,0,0,0,0,0,0,54
2007,Singapore,SGP,-,-,0,0,0,0,0,0,0,0,0,0,0,0,0,0,117
2007,Sierra Leone,SLE,-,-,949,1598,1706,4691,344,118,9406,991,1647,1768,5569,314,249,10538,32114
2007,Solomon Islands,SLB,-,-,0,0,0,0,0,0,0,0,0,0,0,0,0,0,47
2007,Somalia,SOM,-,-,19486,29307,21674,83140,4666,505,158778,20305,31017,26496,118286,5042,525,201671,457345
2007,Spain,ESP,-,-,0,0,0,0,0,0,0,0,0,0,0,0,7,7,37
2007,Viet Nam,VNM,-,-,5,5,35,82,0,5130,5257,0,24,33,107,5,6427,6596,327770
2007,Sao Tome and Principe,STP,-,-,0,8,0,6,0,0,14,0,0,5,13,0,0,18,32
2007,Sudan,SDN,-,-,17958,23812,21663,55117,3362,231,122143,18774,25818,25804,61068,2022,962,134448,523029
2007,Suriname,SUR,-,-,0,0,0,0,0,0,0,0,0,0,0,0,0,0,62
2007,Slovakia,SVK,-,-,0,0,0,0,0,53,53,0,0,0,0,0,53,53,346
2007,Slovenia,SVN,-,-,0,0,0,0,0,0,0,0,0,0,0,0,0,0,47
2007,Eswatini,SWZ,-,-,0,0,0,0,0,0,0,0,0,0,0,0,0,0,21
2007,Sweden,SWE,-,-,0,0,0,0,0,0,0,0,0,0,0,0,0,0,17
2007,Switzerland,CHE,-,-,0,0,0,0,0,0,0,0,0,0,0,0,0,0,33
2007,Syrian Arab Rep.,SYR,-,-,35,91,66,274,14,152,632,31,95,64,361,31,373,955,13684
2007,United Rep. of Tanzania,TZA,-,-,0,0,5,0,0,0,5,0,0,0,10,0,5,15,1250
2007,Thailand,THA,-,-,5,9,8,37,0,0,59,0,8,7,43,5,0,63,2322
2007,Tajikistan,TJK,-,-,0,6,5,6,0,19,36,0,7,0,0,0,19,26,887
2007,Turkmenistan,TKM,-,-,0,0,0,5,0,6,11,0,0,0,8,0,5,13,667
2007,Timor-Leste,TLS,-,-,0,0,0,0,0,0,0,0,0,0,0,0,0,0,6
2007,Togo,TGO,-,-,1069,1150,770,3498,195,377,7059,1044,1189,746,3943,103,687,7712,22481
2007,Trinidad and Tobago,TTO,-,-,0,0,0,0,0,0,0,0,0,0,0,0,0,0,210
2007,Tunisia,TUN,-,-,6,0,6,5,0,319,336,0,10,0,17,0,664,691,2488
2007,Türkiye,TUR,-,-,800,1623,1437,4086,373,4945,13264,891,1776,1417,3716,277,10319,18396,221937
2007,United Arab Emirates,ARE,-,-,0,0,0,0,0,0,0,0,0,0,0,0,0,0,305
2007,Uganda,UGA,-,-,31,282,101,650,117,24,1205,97,456,227,810,178,53,1821,21325
2007,Ukraine,UKR,-,-,0,0,5,19,0,426,450,0,5,0,22,0,367,394,25980
2007,Uruguay,URY,-,-,0,0,0,0,0,5,5,0,0,0,0,0,0,0,193
2007,United States of America,USA,-,-,0,0,0,0,0,0,0,0,0,0,0,0,0,0,2164
2007,Uzbekistan,UZB,-,-,25,30,35,73,0,164,327,27,34,16,70,0,131,278,5658
2007,Saint Vincent and the Grenadines,VCT,-,-,0,0,0,0,0,0,0,0,0,0,0,0,0,0,644
2007,Venezuela (Bolivarian Republic of),VEN,-,-,0,13,12,35,0,0,60,5,5,5,63,5,7,90,5089
2007,Western Sahara,ESH,-,-,0,0,0,0,0,8,8,0,0,47,532,0,7,586,116594
2007,Yemen,YEM,-,-,0,8,27,105,6,40,186,0,19,17,105,15,55,211,1621
2007,Zambia,ZMB,-,-,0,0,0,0,0,0,0,0,0,0,0,0,0,0,192
2007,Zimbabwe,ZWE,-,-,0,0,0,0,0,16,16,5,0,0,0,0,11,16,14366
2007,Stateless,XXA,-,-,0,11,11,32,0,14,68,0,12,14,64,0,45,135,13164
2007,Tibetan,TIB,-,-,0,0,0,0,0,9615,9615,0,0,0,0,0,10555,10555,20170
2007,Unknown ,,-,-,55,62,125,218,15,1642,2117,71,84,126,353,21,2043,2698,194063
2008,Afghanistan,AFG,-,-,33400,173924,149132,409887,24176,989,791508,35045,188840,166489,491298,42065,1421,925158,2833116
2008,Albania,ALB,-,-,0,0,12,6,5,744,767,0,6,5,13,0,848,872,15007
2008,Algeria,DZA,-,-,5,9,24,35,9,537,619,5,11,28,72,0,904,1020,9044
2008,Andorra,AND,-,-,0,0,0,0,0,0,0,0,0,0,0,0,0,0,5
2008,Angola,AGO,-,-,2668,3043,2608,6685,520,1172,16696,2603,3033,2577,7297,650,1803,17963,171374
2008,Antigua and Barbuda,ATG,-,-,0,0,0,0,0,0,0,0,0,0,0,0,0,0,25
2008,Egypt,EGY,-,-,0,15,0,11,0,48,74,0,0,0,30,0,106,136,6777
2008,Argentina,ARG,-,-,0,0,0,5,0,5,10,0,0,0,6,0,0,6,1039
2008,Armenia,ARM,-,-,0,5,49,100,5,1114,1273,0,10,39,105,5,1119,1278,16333
2008,Australia,AUS,-,-,0,0,0,0,0,0,0,0,0,0,0,0,0,0,37
2008,Austria,AUT,-,-,0,0,0,0,0,0,0,0,0,0,0,0,5,5,15
2008,Azerbaijan,AZE,-,-,0,5,29,1242,515,951,2742,0,5,31,1279,260,851,2426,16321
2008,Bahrain,BHR,-,-,0,0,0,0,0,0,0,0,0,0,0,0,0,0,72
2008,Barbados,BRB,-,-,0,0,0,0,0,0,0,0,0,0,0,0,0,0,33
2008,Burundi,BDI,-,-,23434,30338,15780,54762,3960,301,128575,23349,20486,25203,51070,4042,299,124449,281583
2008,Belgium,BEL,-,-,0,0,0,0,0,0,0,0,0,0,0,0,0,0,58
2008,Benin,BEN,-,-,0,0,0,5,0,12,17,5,0,7,0,0,13,25,315
2008,Bangladesh,BGD,-,-,0,7,0,13,0,199,219,5,5,5,40,0,1536,1591,10097
2008,Bahamas,BHS,-,-,0,0,0,0,0,0,0,0,0,0,0,0,0,0,11
2008,Bhutan,BTN,-,-,3826,6004,6138,29786,3228,1227,50209,4065,6310,6237,30291,3767,1244,51914,104960
2008,Burkina Faso,BFA,-,-,0,0,0,0,0,18,18,0,5,0,5,0,46,56,719
2008,Belarus,BLR,-,-,0,5,5,5,0,237,252,0,5,0,21,0,305,331,5376
2008,Bolivia (Plurinational State of),BOL,-,-,0,5,0,8,0,18,31,0,0,0,0,0,27,27,455
2008,Botswana,BWA,-,-,0,0,0,0,0,0,0,0,0,0,0,0,0,0,29
2008,Brazil,BRA,-,-,0,0,0,0,0,9,9,0,0,0,0,0,5,5,1401
2008,Bosnia and Herzegovina,BIH,-,-,77,718,1211,11231,6294,3347,22878,68,747,1306,10699,3493,3506,19819,74358
2008,Bulgaria,BGR,-,-,0,5,0,22,0,53,80,0,0,0,13,0,76,89,3036
2008,Belize,BLZ,-,-,0,0,0,0,0,0,0,0,0,0,0,0,0,0,18
2008,Cambodia,KHM,-,-,0,11,12,26,5,8146,8200,0,5,5,34,5,7930,7979,17250
2008,Canada,CAN,-,-,0,0,0,0,0,0,0,0,0,0,0,0,0,0,100
2008,Central African Rep.,CAF,-,-,10604,16358,8268,24059,1117,332,60738,10661,16500,7669,17685,1529,412,54456,125090
2008,Chad,TCD,-,-,1739,833,1693,4439,462,17155,26321,1635,760,1720,5416,320,17625,27476,55083
2008,China,CHN,-,-,23,44,36,284,10,595,992,31,48,21,421,6,917,1444,175169
2008,Chile,CHL,-,-,0,0,0,5,0,75,80,0,0,0,7,0,82,89,988
2008,Cameroon,CMR,-,-,257,159,200,523,49,285,1473,195,109,180,281,22,521,1308,13852
2008,Congo,COG,-,-,280,761,647,2338,97,1464,5587,306,786,519,2936,90,1475,6112,19922
2008,Dem. Rep. of the Congo,COD,-,-,24906,30448,24597,60817,3480,5570,149818,24481,29230,25196,54013,2831,6397,142148,367991
2008,Comoros,COM,-,-,0,0,0,0,0,82,82,0,0,0,0,0,257,257,376
2008,Colombia,COL,-,-,654,1921,1751,9207,371,838,14742,745,2136,2103,11077,732,951,17744,373532
2008,Costa Rica,CRI,-,-,0,0,0,0,0,0,0,0,0,0,0,0,0,0,354
2008,Cuba,CUB,-,-,12,34,71,555,36,60,768,29,54,92,888,72,94,1229,7928
2008,Cabo Verde,CPV,-,-,0,0,0,0,0,0,0,0,0,0,0,0,0,0,27
2008,Cyprus,CYP,-,-,0,0,0,0,0,0,0,0,0,0,5,0,0,5,10
2008,Czechia,CZE,-,-,0,0,0,0,0,23,23,0,0,0,0,5,31,36,1354
2008,Denmark,DNK,-,-,0,0,0,0,0,0,0,0,0,0,0,0,0,0,10
2008,Djibouti,DJI,-,-,0,8,0,13,0,63,84,5,5,0,26,0,66,102,638
2008,Dominica,DMA,-,-,0,0,0,0,0,0,0,0,0,0,0,0,0,0,56
2008,Dominican Rep.,DOM,-,-,0,0,5,0,0,0,5,0,0,0,6,0,0,6,313
2008,Ecuador,ECU,-,-,0,0,0,6,0,15,21,0,0,0,13,0,26,39,1063
2008,Equatorial Guinea,GNQ,-,-,0,10,5,24,0,13,52,0,5,12,31,0,17,65,381
2008,Eritrea,ERI,-,-,5569,9034,5766,32837,1772,15738,70716,5826,9470,6431,41085,2670,16264,81746,186392
2008,Estonia,EST,-,-,0,0,0,0,0,5,5,0,0,0,0,0,10,10,248
2008,Ethiopia,ETH,-,-,1608,1987,1140,8768,182,2842,16527,1672,2231,1327,14097,269,2110,21706,63863
2008,Fiji,FJI,-,-,0,0,0,0,0,0,0,0,0,0,0,0,0,0,1862
2008,France,FRA,-,-,0,0,0,0,0,0,0,0,0,0,0,0,0,0,97
2008,Gabon,GAB,-,-,0,0,6,0,0,5,11,0,0,0,0,0,15,15,132
2008,Gambia,GMB,-,-,0,0,0,0,0,26,26,0,0,0,0,0,48,48,1336
2008,Palestinian,PSE,-,-,6954,9079,6079,17883,1491,62,41548,7674,6094,11172,19903,1344,126,46313,340004
2008,United Kingdom of Great Britain and Northern Ireland,GBR,-,-,0,0,0,0,0,0,0,0,0,0,0,0,0,0,182
2008,Georgia,GEO,-,-,5,0,17,112,15,1004,1153,0,5,16,95,5,907,1028,12597
2008,Germany,DEU,-,-,0,0,0,0,0,11,11,0,0,0,0,0,5,5,162
2008,Ghana,GHA,-,-,998,1556,557,1553,21,218,4903,1100,995,427,982,21,356,3881,13225
2008,Guinea-Bissau,GNB,-,-,0,0,0,5,0,250,255,0,0,0,19,0,598,617,1053
2008,Greece,GRC,-,-,0,0,0,0,0,0,0,0,0,0,0,0,0,0,67
2008,Grenada,GRD,-,-,0,0,0,0,0,0,0,0,0,0,0,0,0,0,310
2008,Guatemala,GTM,-,-,0,10,23,63,20,5,121,0,5,50,110,16,20,201,5927
2008,Guinea,GIN,-,-,0,11,5,30,0,1187,1233,0,12,0,67,0,1433,1512,9481
2008,Guyana,GUY,-,-,0,0,0,0,0,0,0,0,0,0,0,0,0,0,707
2008,Haiti,HTI,-,-,5,11,13,47,0,1335,1411,0,12,19,104,9,1825,1969,23059
2008,"China, Hong Kong SAR",HKG,-,-,0,0,0,0,0,0,0,0,0,0,0,0,0,0,9
2008,Honduras,HND,-,-,5,0,8,19,0,0,32,0,0,5,19,0,0,24,1116
2008,Croatia,HRV,-,-,43,1260,2436,22078,14068,55,39940,49,1292,2540,26359,8849,54,39143,97016
2008,Hungary,HUN,-,-,0,0,0,0,0,45,45,0,0,0,9,6,146,161,1612
2008,Iceland,ISL,-,-,0,0,0,0,0,0,0,0,0,0,0,0,0,0,10
2008,Cote d'Ivoire,CIV,-,-,448,938,806,3880,157,543,6772,422,930,881,5652,185,1113,9183,22218
2008,India,IND,-,-,0,0,0,6,0,45,51,0,5,0,17,0,188,210,19551
2008,Indonesia,IDN,-,-,142,212,179,623,46,6,1208,142,243,206,661,51,0,1303,19339
2008,Ireland,IRL,-,-,0,0,0,0,0,0,0,0,0,0,0,0,0,0,7
2008,Iran (Islamic Rep. of),IRN,-,-,390,1129,987,3809,267,986,7568,354,1153,1120,4687,334,1729,9377,69051
2008,Iraq,IRQ,-,-,75505,122934,106317,465613,62311,1546,834226,78433,132786,115668,469862,53664,2152,852565,1903516
2008,Israel,ISR,-,-,0,0,0,12,0,0,12,0,0,0,9,0,0,9,1486
2008,Italy,ITA,-,-,0,0,0,0,0,0,0,0,0,0,0,0,0,0,57
2008,Jamaica,JAM,-,-,0,0,0,0,0,0,0,0,0,0,0,0,0,0,825
2008,Jordan,JOR,-,-,0,13,0,74,8,5,100,0,0,0,26,0,16,42,1882
2008,Japan,JPN,-,-,0,0,0,0,0,0,0,0,0,0,0,0,0,0,183
2008,Kazakhstan,KAZ,-,-,0,0,0,8,0,200,208,0,0,0,12,0,145,157,4825
2008,Kenya,KEN,-,-,402,237,715,904,92,13,2363,405,237,585,907,99,20,2253,9682
2008,Kyrgyzstan,KGZ,-,-,0,0,0,0,0,87,87,0,5,0,12,0,79,96,2526
2008,Kiribati,KIR,-,-,0,0,0,0,0,0,0,0,0,0,0,0,0,0,36
2008,Rep. of Korea,KOR,-,-,0,0,0,0,0,0,0,0,0,0,0,0,0,0,1099
2008,Dem. People's Rep. of Korea,PRK,-,-,0,0,0,0,0,0,0,0,0,0,12,0,9,21,881
2008,Kuwait,KWT,-,-,0,0,0,6,0,0,6,0,0,0,14,0,0,14,847
2008,Lao People's Dem. Rep.,LAO,-,-,22,50,34,78,5,3699,3888,34,51,34,117,7,3992,4235,8596
2008,Liberia,LBR,-,-,3516,6357,4264,19040,840,71,34088,3555,6239,4039,17774,705,169,32481,75221
2008,Libya,LBY,-,-,6,0,0,5,0,112,123,0,5,0,11,0,191,207,2068
2008,Saint Lucia,LCA,-,-,0,0,0,0,0,0,0,0,0,0,0,0,0,0,288
2008,Lebanon,LBN,-,-,0,7,0,33,0,38,78,0,0,6,52,0,107,165,12966
2008,Lesotho,LSO,-,-,0,0,0,0,0,0,0,0,0,0,0,0,0,0,5
2008,Sri Lanka,LKA,-,-,92,161,107,683,153,42642,43838,98,183,103,1838,54,49615,51891,137742
2008,Lithuania,LTU,-,-,0,0,0,0,0,9,9,0,0,0,0,0,24,24,486
2008,Latvia,LVA,-,-,0,0,0,5,0,31,36,0,0,0,5,0,19,24,765
2008,"China, Macao SAR",MAC,-,-,0,0,0,0,0,0,0,0,0,0,0,0,0,0,8
2008,Madagascar,MDG,-,-,0,0,0,0,0,104,104,0,0,0,5,0,117,122,278
2008,Mauritania,MRT,-,-,3763,4542,3947,6842,1406,763,21263,2530,4099,3478,6617,1253,3438,21415,45592
2008,North Macedonia,MKD,-,-,5,16,9,40,5,105,180,6,13,9,35,0,138,201,7513
2008,Rep. of Moldova,MDA,-,-,5,0,0,7,0,187,199,0,0,0,0,0,189,189,5551
2008,Maldives,MDV,-,-,0,0,0,0,0,0,0,0,0,0,0,0,5,5,15
2008,Mexico,MEX,-,-,0,0,0,0,0,0,0,0,0,0,7,0,5,12,6160
2008,Mali,MLI,-,-,0,0,0,7,0,645,652,0,0,0,10,0,409,419,1751
2008,Malaysia,MYS,-,-,0,0,0,0,0,0,0,0,0,0,0,0,5,5,607
2008,Malawi,MWI,-,-,0,0,0,0,0,0,0,0,0,0,0,0,0,0,103
2008,Mongolia,MNG,-,-,0,5,0,15,0,129,149,0,0,6,17,0,89,112,1329
2008,Morocco,MAR,-,-,0,0,0,19,0,35,54,0,0,0,10,0,91,101,3520
2008,Mozambique,MOZ,-,-,0,0,0,0,0,5,5,0,9,0,0,0,8,17,198
2008,Malta,MLT,-,-,0,0,0,0,0,0,0,0,0,0,0,0,0,0,10
2008,Montenegro,MNE,-,-,0,0,0,0,0,19,19,0,0,7,0,0,7,14,1280
2008,Mauritius,MUS,-,-,0,0,0,0,0,0,0,0,0,0,0,0,0,0,20
2008,Myanmar,MMR,-,-,12274,15394,11970,40063,2880,311,82892,12934,15804,12804,48722,2943,597,93804,184410
2008,Namibia,NAM,-,-,42,55,26,138,0,0,261,56,57,22,529,12,0,676,976
2008,Nepal,NPL,-,-,0,0,8,0,0,23,31,0,0,0,62,0,48,110,4190
2008,Netherlands,NLD,-,-,0,0,0,0,0,0,0,0,0,0,0,0,0,0,46
2008,Niger,NER,-,-,0,5,0,0,0,25,30,8,0,0,5,0,34,47,789
2008,Nicaragua,NIC,-,-,12,27,40,314,31,0,424,17,36,36,432,30,0,551,1533
2008,Nigeria,NGA,-,-,191,342,313,777,36,270,1929,230,381,262,650,61,356,1940,14170
2008,New Zealand,NZL,-,-,0,0,0,0,0,0,0,0,0,0,0,0,0,0,8
2008,Oman,OMN,-,-,0,0,0,0,0,0,0,0,0,0,0,0,0,0,55
2008,Pakistan,PAK,-,-,29,47,14,126,5,137,358,23,48,34,205,5,336,651,32391
2008,Panama,PAN,-,-,0,0,0,8,0,0,8,0,0,0,10,0,0,10,106
2008,Paraguay,PRY,-,-,0,0,0,0,0,0,0,0,0,0,7,0,0,7,97
2008,Peru,PER,-,-,5,28,58,334,5,121,551,18,25,37,406,19,160,665,7329
2008,Philippines,PHL,-,-,0,0,0,0,0,0,0,0,0,0,0,0,0,0,1348
2008,Papua New Guinea,PNG,-,-,0,0,0,0,0,0,0,0,0,0,0,0,0,0,44
2008,Poland,POL,-,-,0,0,0,0,0,247,247,0,0,0,5,5,282,292,2385
2008,Portugal,PRT,-,-,0,0,0,0,0,5,5,0,0,0,0,0,0,0,35
2008,Qatar,QAT,-,-,0,0,0,0,0,0,0,0,0,0,0,0,0,0,69
2008,Romania,ROU,-,-,0,0,0,18,7,124,149,0,0,0,13,0,149,162,4747
2008,South Africa,ZAF,-,-,0,0,0,6,0,5,11,0,0,0,5,0,13,18,449
2008,Russian Federation,RUS,-,-,249,619,556,2221,116,5655,9416,294,709,555,1993,88,6059,9698,103061
2008,Rwanda,RWA,-,-,2764,3621,2689,8378,205,1893,19550,2759,3747,2744,10347,323,1593,21513,72529
2008,El Salvador,SLV,-,-,8,12,26,308,50,5,409,0,13,25,353,123,11,525,5154
2008,Saudi Arabia,SAU,-,-,0,5,0,0,0,0,5,0,0,0,0,0,0,0,700
2008,Serbia and Kosovo: S/RES/1244 (1999),SRB,-,-,580,1659,1691,6312,1598,4971,16811,673,1836,1878,5886,1183,6785,18241,185930
2008,Senegal,SEN,-,-,1225,2279,2559,1572,352,82,8069,1257,1313,1621,2431,444,117,7183,16007
2008,Seychelles,SYC,-,-,0,0,0,0,0,0,0,0,0,0,0,0,0,0,51
2008,Singapore,SGP,-,-,0,0,0,0,0,0,0,0,0,0,0,0,0,0,106
2008,Sierra Leone,SLE,-,-,998,1624,1715,4751,356,128,9572,991,1650,1763,5631,557,256,10848,32517
2008,Solomon Islands,SLB,-,-,0,0,0,0,0,0,0,0,0,0,0,0,0,0,51
2008,Somalia,SOM,-,-,26155,39343,28111,104827,5871,499,204806,27323,42258,34724,148763,5646,513,259227,561145
2008,Spain,ESP,-,-,0,0,0,0,0,0,0,0,0,0,0,0,5,5,26
2008,Viet Nam,VNM,-,-,5,24,29,61,0,5021,5140,5,25,21,82,0,6195,6328,328175
2008,Sao Tome and Principe,STP,-,-,0,7,0,7,0,0,14,0,0,5,13,0,0,18,32
2008,Sudan,SDN,-,-,31741,47856,26064,80832,6450,236,193179,32361,46892,26834,58026,4297,1062,169472,419249
2008,Suriname,SUR,-,-,0,0,0,0,0,0,0,0,0,0,0,0,0,0,50
2008,Slovakia,SVK,-,-,0,0,0,0,0,57,57,0,0,0,0,0,51,51,333
2008,Slovenia,SVN,-,-,0,0,0,0,0,0,0,0,0,0,0,0,0,0,49
2008,Eswatini,SWZ,-,-,0,0,0,0,0,0,0,0,0,0,0,0,0,0,28
2008,Sweden,SWE,-,-,0,0,0,0,0,0,0,0,0,0,0,0,0,0,16
2008,Switzerland,CHE,-,-,0,0,0,0,0,0,0,0,0,0,0,0,0,0,32
2008,Syrian Arab Rep.,SYR,-,-,26,105,81,281,11,187,691,45,96,81,474,41,403,1140,15206
2008,United Rep. of Tanzania,TZA,-,-,0,5,0,0,0,0,5,0,0,0,5,0,10,15,1262
2008,Thailand,THA,-,-,5,9,8,38,0,0,60,0,7,8,42,5,0,62,1811
2008,Tajikistan,TJK,-,-,0,0,5,11,0,11,27,0,11,0,11,0,14,36,541
2008,Turkmenistan,TKM,-,-,0,0,0,5,0,10,15,0,0,0,15,0,5,20,735
2008,Timor-Leste,TLS,-,-,0,0,0,0,0,0,0,0,0,0,0,0,0,0,7
2008,Togo,TGO,-,-,532,531,439,1737,117,431,3787,507,558,424,2758,51,749,5047,16734
2008,Tonga,TON,-,-,0,0,0,0,0,0,0,0,0,0,0,0,0,0,5
2008,Trinidad and Tobago,TTO,-,-,0,0,0,0,0,0,0,0,0,0,0,0,0,0,228
2008,Tunisia,TUN,-,-,5,0,6,7,0,295,313,0,10,5,19,0,659,693,2334
2008,Türkiye,TUR,-,-,600,1655,1379,4361,392,4884,13271,654,1816,1344,4085,308,10534,18741,214365
2008,United Arab Emirates,ARE,-,-,0,0,0,0,0,0,0,0,0,0,0,0,0,0,255
2008,Uganda,UGA,-,-,200,215,119,657,0,33,1224,34,172,214,1242,210,46,1918,7533
2008,Ukraine,UKR,-,-,7,0,0,14,0,423,444,0,0,9,16,0,361,386,28416
2008,Uruguay,URY,-,-,0,0,0,0,0,0,0,0,0,0,0,0,0,0,194
2008,United States of America,USA,-,-,0,0,0,0,0,0,0,0,0,0,0,0,0,0,2126
2008,Uzbekistan,UZB,-,-,19,33,27,95,0,135,309,40,48,23,76,0,103,290,6297
2008,Saint Vincent and the Grenadines,VCT,-,-,0,0,0,0,0,0,0,0,0,0,0,0,0,0,748
2008,Venezuela (Bolivarian Republic of),VEN,-,-,5,11,13,53,0,0,82,5,8,14,78,5,8,118,5801
2008,Samoa,WSM,-,-,0,0,0,0,0,0,0,0,0,0,0,0,0,0,5
2008,Western Sahara,ESH,-,-,0,0,0,0,0,8,8,0,0,21,488,0,11,520,116528
2008,Yemen,YEM,-,-,5,15,27,112,6,39,204,5,20,18,115,15,67,240,1764
2008,Zambia,ZMB,-,-,0,0,0,0,0,0,0,0,0,0,0,0,0,0,191
2008,Zimbabwe,ZWE,-,-,53,50,62,175,10,9,359,38,33,71,323,6,12,483,16824
2008,Stateless,XXA,-,-,12,7,13,50,0,0,82,5,14,10,91,0,0,120,14168
2008,Tibetan,TIB,-,-,0,0,0,0,0,10005,10005,0,0,0,0,0,10012,10012,20080
2008,Unknown ,,-,-,49,25,14,606,5,8476,9175,45,22,21,655,13,9770,10526,190688
2009,Afghanistan,AFG,-,-,22977,184795,159892,446210,27798,463,842135,24427,196176,181171,539182,45959,645,987560,2887114
2009,Albania,ALB,-,-,5,35,119,709,60,90,1018,16,54,87,1223,54,142,1576,15707
2009,Algeria,DZA,-,-,31,88,141,482,13,56,811,31,107,136,1468,17,95,1854,8168
2009,Andorra,AND,-,-,0,0,0,0,0,0,0,0,0,0,0,0,0,0,5
2009,Angola,AGO,-,-,7961,9341,8055,31000,4288,50,60695,7654,9191,8956,27667,1604,92,55164,141006
2009,Antigua and Barbuda,ATG,-,-,0,0,0,0,0,0,0,0,0,0,0,0,0,0,27
2009,Egypt,EGY,-,-,12,35,22,102,14,8,193,33,45,31,523,69,32,733,6983
2009,Argentina,ARG,-,-,0,0,7,5,9,0,21,5,0,0,16,5,0,26,604
2009,Armenia,ARM,-,-,32,161,299,1373,145,26,2036,28,143,280,1438,101,36,2026,18004
2009,Australia,AUS,-,-,0,0,5,0,7,0,12,0,6,0,5,0,0,11,23
2009,Austria,AUT,-,-,0,0,0,5,0,0,5,0,0,0,0,0,5,5,15
2009,Azerbaijan,AZE,-,-,58,276,351,3006,908,30,4629,87,278,366,3155,537,34,4457,16945
2009,Bahrain,BHR,-,-,0,0,0,7,0,0,7,0,0,0,6,5,0,11,72
2009,Barbados,BRB,-,-,0,0,0,0,0,0,0,0,0,0,0,0,0,0,28
2009,Burundi,BDI,-,-,6890,8122,4757,12899,982,152,33802,8387,9765,5956,13953,868,151,39080,94221
2009,Belgium,BEL,-,-,0,0,0,0,0,0,0,0,0,0,0,0,0,0,66
2009,Benin,BEN,-,-,5,9,0,42,0,7,63,0,7,14,119,0,5,145,409
2009,Bangladesh,BGD,-,-,7,10,23,121,5,10,176,17,29,8,815,9,10,888,10428
2009,Bahamas,BHS,-,-,0,0,0,0,0,0,0,0,0,0,0,0,0,0,12
2009,Bhutan,BTN,-,-,3403,5045,5548,24538,2626,1119,42279,3615,5284,5674,24951,3090,1118,43732,89064
2009,Burkina Faso,BFA,-,-,0,7,12,35,0,12,66,7,13,0,130,0,15,165,983
2009,Belarus,BLR,-,-,10,63,80,662,112,45,972,9,57,86,584,88,63,887,5518
2009,Bolivia (Plurinational State of),BOL,-,-,5,5,13,44,5,0,72,5,6,10,65,11,5,102,570
2009,Botswana,BWA,-,-,0,0,0,0,0,0,0,0,0,0,0,0,0,0,32
2009,Brazil,BRA,-,-,5,11,18,62,11,6,113,5,14,11,26,0,0,56,973
2009,Bosnia and Herzegovina,BIH,-,-,129,1103,2075,19840,6978,1380,31505,142,1167,2107,19085,4194,1311,28006,70006
2009,Bulgaria,BGR,-,-,6,7,12,75,7,18,125,8,7,7,50,30,21,123,2743
2009,Belize,BLZ,-,-,0,0,0,0,0,0,0,0,0,0,0,0,0,0,16
2009,Cambodia,KHM,-,-,0,16,16,63,5,1445,1545,0,8,15,108,13,1425,1569,17022
2009,Canada,CAN,-,-,5,6,0,9,5,0,25,9,9,0,9,0,0,27,97
2009,Central African Rep.,CAF,-,-,13415,20760,10823,31937,2484,179,79598,12790,20255,10294,22761,2574,198,68872,159542
2009,Chad,TCD,-,-,727,1047,673,3147,191,3226,9011,754,942,650,4579,208,3282,10415,54997
2009,China,CHN,-,-,88,203,156,1416,70,349,2282,89,200,178,2125,73,621,3286,180546
2009,Chile,CHL,-,-,0,5,0,127,65,32,229,0,0,8,184,75,45,312,1305
2009,Cameroon,CMR,-,-,251,227,289,971,65,127,1930,207,217,229,852,35,159,1699,14752
2009,Congo,COG,-,-,398,868,728,2600,102,58,4754,368,901,619,3298,113,90,5389,20546
2009,Dem. Rep. of the Congo,COD,-,-,26861,34842,23110,65495,3792,7359,161459,26994,34198,23075,60499,3509,7050,155325,455852
2009,Comoros,COM,-,-,0,0,0,0,0,0,0,0,0,0,5,0,0,5,268
2009,Colombia,COL,-,-,1120,3375,3171,18454,787,740,27647,1229,3551,3582,20934,1240,796,31332,389753
2009,Costa Rica,CRI,-,-,0,0,0,0,0,0,0,0,8,0,0,0,0,8,344
2009,Cuba,CUB,-,-,13,41,79,687,50,15,885,29,63,103,1159,71,17,1442,7537
2009,Cabo Verde,CPV,-,-,0,0,0,0,0,0,0,0,0,0,5,0,0,5,22
2009,Cyprus,CYP,-,-,0,0,0,5,0,0,5,0,0,0,0,0,0,0,10
2009,Czechia,CZE,-,-,0,5,0,20,31,12,68,0,0,0,45,64,12,121,1060
2009,Denmark,DNK,-,-,0,0,0,0,0,0,0,0,0,0,0,0,0,0,10
2009,Djibouti,DJI,-,-,0,5,6,22,0,26,59,6,6,0,30,0,33,75,613
2009,Dominica,DMA,-,-,0,0,0,0,0,0,0,0,0,0,0,0,0,0,51
2009,Dominican Rep.,DOM,-,-,0,5,20,5,0,0,30,0,5,9,13,0,0,27,222
2009,Ecuador,ECU,-,-,5,9,17,42,0,6,79,0,18,10,50,0,0,78,1029
2009,Equatorial Guinea,GNQ,-,-,0,0,10,31,0,0,41,0,6,5,42,0,0,53,341
2009,Eritrea,ERI,-,-,6298,9096,7179,30943,2237,6793,62546,6712,9620,8332,41481,3123,7622,76890,209164
2009,Estonia,EST,-,-,0,0,5,29,14,0,48,0,0,5,18,8,5,36,249
2009,Ethiopia,ETH,-,-,1954,2238,1264,10355,296,1303,17410,2049,2282,1412,13674,366,1301,21084,62877
2009,Fiji,FJI,-,-,0,0,0,0,0,0,0,0,0,0,0,0,0,0,1888
2009,Finland,FIN,-,-,0,0,0,0,0,0,0,0,0,0,0,0,0,0,6
2009,France,FRA,-,-,0,0,0,0,0,0,0,0,0,0,0,0,0,0,80
2009,Gabon,GAB,-,-,0,5,6,5,0,0,16,0,0,0,5,0,0,5,145
2009,Gambia,GMB,-,-,7,0,15,34,0,9,65,5,11,7,396,9,11,439,1966
2009,Palestinian,PSE,-,-,6888,9048,6056,17953,1532,35,41512,7621,6049,11116,19929,1403,52,46170,95185
2009,United Kingdom of Great Britain and Northern Ireland,GBR,-,-,5,0,0,0,0,0,5,0,0,0,0,0,0,0,155
2009,Georgia,GEO,-,-,14,81,110,790,160,7,1162,10,69,120,710,90,12,1011,15015
2009,Germany,DEU,-,-,0,0,0,0,0,5,5,0,0,0,0,0,0,0,167
2009,Ghana,GHA,-,-,1029,1654,669,3133,54,0,6539,1135,1068,511,3024,169,8,5915,14876
2009,Guinea-Bissau,GNB,-,-,0,0,7,5,0,8,20,0,0,5,61,0,5,71,1100
2009,Greece,GRC,-,-,0,0,0,0,0,0,0,0,0,0,6,0,0,6,61
2009,Grenada,GRD,-,-,0,0,0,0,0,0,0,0,0,0,0,0,0,0,332
2009,Guatemala,GTM,-,-,0,6,16,75,23,0,120,0,11,45,121,35,6,218,5763
2009,Guinea,GIN,-,-,23,46,27,172,0,457,725,14,34,20,371,12,292,743,10912
2009,Guyana,GUY,-,-,0,0,0,0,0,0,0,0,0,0,0,0,0,0,724
2009,Haiti,HTI,-,-,13,23,22,83,0,8,149,6,24,29,139,0,0,198,24110
2009,"China, Hong Kong SAR",HKG,-,-,0,0,0,0,0,0,0,0,0,0,0,0,0,0,10
2009,Honduras,HND,-,-,0,10,9,37,0,0,56,0,5,5,56,0,0,66,1165
2009,Croatia,HRV,-,-,43,1179,2368,21471,12861,22,37944,44,1255,2428,25367,8390,15,37499,76479
2009,Hungary,HUN,-,-,0,0,0,17,12,19,48,0,0,0,34,83,99,216,1535
2009,Iceland,ISL,-,-,0,0,0,0,0,0,0,0,0,0,0,0,0,0,5
2009,Cote d'Ivoire,CIV,-,-,959,1272,954,2984,198,100,6467,885,1334,1000,4820,138,341,8518,23148
2009,India,IND,-,-,40,43,13,184,20,7,307,37,41,31,2421,83,10,2623,19496
2009,Indonesia,IDN,-,-,69,108,93,351,28,0,649,74,118,108,339,42,0,681,18207
2009,Ireland,IRL,-,-,0,0,0,0,0,0,0,0,0,0,0,0,0,0,7
2009,Iran (Islamic Rep. of),IRN,-,-,460,1595,1688,9972,1633,407,15755,478,1566,1818,14877,1669,674,21082,72771
2009,Iraq,IRQ,-,-,67380,114408,100229,438417,60574,1294,782302,71165,120496,107537,494719,56285,1817,852019,1785215
2009,Israel,ISR,-,-,6,22,13,93,65,0,199,6,16,16,90,44,0,172,1298
2009,Italy,ITA,-,-,0,0,0,5,0,5,10,0,0,0,5,0,0,5,42
2009,Jamaica,JAM,-,-,0,0,0,8,0,0,8,0,8,0,0,0,0,8,908
2009,Jordan,JOR,-,-,8,35,31,152,10,13,249,12,46,28,422,74,7,589,2109
2009,Japan,JPN,-,-,13,18,9,19,0,0,59,21,22,12,7,0,0,62,148
2009,Kazakhstan,KAZ,-,-,10,47,65,603,208,11,944,11,51,64,561,64,7,758,3741
2009,Kenya,KEN,-,-,327,569,420,1040,106,8,2470,348,517,363,886,117,13,2244,9609
2009,Kyrgyzstan,KGZ,-,-,0,37,47,459,193,14,750,5,32,72,403,129,11,652,2611
2009,Kiribati,KIR,-,-,0,0,0,0,0,0,0,0,0,0,0,0,0,0,31
2009,Rep. of Korea,KOR,-,-,5,35,27,38,5,0,110,7,39,28,37,5,0,116,567
2009,Dem. People's Rep. of Korea,PRK,-,-,0,0,0,73,0,5,78,0,6,0,89,0,8,103,878
2009,Kuwait,KWT,-,-,5,5,0,47,8,0,65,0,7,11,81,9,0,108,936
2009,Lao People's Dem. Rep.,LAO,-,-,17,33,23,99,17,79,268,24,32,26,159,14,106,361,8397
2009,Liberia,LBR,-,-,2625,5876,4435,18668,799,27,32430,2705,5801,4389,17520,853,75,31343,71601
2009,Libya,LBY,-,-,30,26,26,125,9,110,326,20,37,20,288,34,169,568,2189
2009,Saint Lucia,LCA,-,-,0,0,0,0,0,0,0,0,0,0,0,0,0,0,312
2009,Lebanon,LBN,-,-,90,357,617,4103,547,19,5733,131,416,643,5626,537,43,7396,16250
2009,Lesotho,LSO,-,-,0,0,0,0,0,0,0,0,0,0,0,0,0,0,5
2009,Sri Lanka,LKA,-,-,158,487,428,4150,646,36042,41911,160,499,483,9252,737,37916,49047,145711
2009,Lithuania,LTU,-,-,0,8,15,64,21,7,115,0,12,7,63,18,11,111,496
2009,Latvia,LVA,-,-,0,13,15,137,89,5,259,0,13,22,115,69,0,219,787
2009,"China, Macao SAR",MAC,-,-,0,0,0,0,0,0,0,0,0,0,0,0,0,0,8
2009,Madagascar,MDG,-,-,0,0,0,14,0,0,14,0,0,0,6,0,0,6,271
2009,Mauritania,MRT,-,-,2479,3543,2497,6867,624,22,16032,2744,3097,2547,6835,701,158,16082,39134
2009,North Macedonia,MKD,-,-,44,164,306,1990,74,10,2588,43,196,311,3029,65,30,3674,7921
2009,Rep. of Moldova,MDA,-,-,12,60,147,1273,669,0,2161,10,73,130,1199,483,6,1901,5928
2009,Maldives,MDV,-,-,0,0,0,0,0,0,0,0,0,0,0,0,5,5,15
2009,Mexico,MEX,-,-,0,0,5,11,0,0,16,0,5,5,13,0,0,23,6433
2009,Mali,MLI,-,-,0,0,7,19,0,5,31,5,5,0,52,5,0,67,2927
2009,Malaysia,MYS,-,-,0,5,0,9,0,0,14,0,0,0,13,0,5,18,530
2009,Malawi,MWI,-,-,0,0,0,0,0,0,0,0,0,0,0,0,0,0,126
2009,Mongolia,MNG,-,-,0,17,15,99,0,0,131,5,16,5,65,0,0,91,1490
2009,Morocco,MAR,-,-,15,26,29,327,24,11,432,11,38,27,1040,27,19,1162,2277
2009,Mozambique,MOZ,-,-,0,11,0,20,0,0,31,0,0,5,66,0,0,71,130
2009,Malta,MLT,-,-,0,0,0,0,0,0,0,0,0,0,0,0,0,0,10
2009,Montenegro,MNE,-,-,43,129,185,737,24,5,1123,34,120,219,929,23,0,1325,2578
2009,Mauritius,MUS,-,-,0,0,0,0,0,0,0,0,0,0,0,0,0,0,21
2009,Myanmar,MMR,-,-,12715,15142,12097,44689,3004,370,88017,13318,15818,13377,64878,3088,839,111318,406667
2009,Namibia,NAM,-,-,42,47,26,134,0,0,249,53,51,22,507,9,0,642,918
2009,Nepal,NPL,-,-,0,15,9,74,0,15,113,5,10,13,270,5,15,318,5101
2009,Netherlands,NLD,-,-,0,0,0,7,0,0,7,0,0,0,0,0,0,0,44
2009,Niger,NER,-,-,6,14,5,27,0,17,69,10,6,7,132,0,8,163,812
2009,Nicaragua,NIC,-,-,12,27,40,309,31,0,419,17,36,43,429,30,0,555,1473
2009,Nigeria,NGA,-,-,200,374,412,1329,48,11,2374,195,438,365,2418,93,13,3522,15609
2009,New Zealand,NZL,-,-,0,0,0,0,0,0,0,0,0,9,0,0,0,9,9
2009,Oman,OMN,-,-,0,0,5,12,0,0,17,5,7,0,13,0,0,25,63
2009,Pakistan,PAK,-,-,118,334,308,1758,223,43,2784,124,348,282,3961,356,82,5153,35129
2009,Panama,PAN,-,-,0,0,0,13,0,0,13,0,0,0,10,0,0,10,102
2009,Paraguay,PRY,-,-,0,0,0,7,0,0,7,0,0,0,7,0,0,7,77
2009,Peru,PER,-,-,5,14,71,436,18,5,549,6,24,52,508,31,5,626,6272
2009,Philippines,PHL,-,-,0,5,11,115,11,0,142,0,9,14,44,7,0,74,987
2009,Papua New Guinea,PNG,-,-,0,0,0,0,0,0,0,0,0,0,0,0,0,0,68
2009,Poland,POL,-,-,12,37,46,206,56,137,494,14,41,42,217,82,175,571,2052
2009,Portugal,PRT,-,-,0,0,0,0,0,5,5,0,5,0,0,0,0,5,30
2009,Qatar,QAT,-,-,0,5,0,12,0,0,17,0,8,0,30,0,0,38,66
2009,Romania,ROU,-,-,6,21,19,209,126,30,411,5,23,13,202,85,44,372,4350
2009,South Africa,ZAF,-,-,0,5,5,15,0,0,25,0,0,8,23,10,0,41,380
2009,Russian Federation,RUS,-,-,448,1633,1757,12803,7233,1681,25555,493,1735,1852,11402,5079,1903,22464,109452
2009,Rwanda,RWA,-,-,2716,3954,2588,8657,266,858,19039,2689,3981,2644,10708,398,794,21214,129108
2009,El Salvador,SLV,-,-,0,10,10,252,56,0,328,0,6,30,353,133,0,522,5053
2009,Saudi Arabia,SAU,-,-,13,17,9,90,19,0,148,8,20,13,162,18,0,221,629
2009,Serbia and Kosovo: S/RES/1244 (1999),SRB,-,-,1815,7215,10448,43715,3248,1368,67809,2016,7509,10851,56376,2985,1677,81414,195625
2009,Senegal,SEN,-,-,1229,2382,2627,1516,399,14,8167,1257,1433,1730,2203,458,27,7108,16306
2009,Seychelles,SYC,-,-,0,0,0,0,0,0,0,0,0,0,0,0,0,0,47
2009,Singapore,SGP,-,-,0,0,0,9,0,0,9,0,0,0,0,0,0,0,77
2009,Sierra Leone,SLE,-,-,236,326,391,833,81,55,1922,202,331,356,1159,301,205,2554,15398
2009,Solomon Islands,SLB,-,-,0,0,0,0,0,0,0,0,0,0,0,0,0,0,65
2009,Somalia,SOM,-,-,35802,52483,32393,128734,7179,184,256775,37976,55329,39520,179807,6646,232,319510,678296
2009,Spain,ESP,-,-,0,0,0,0,0,0,0,0,0,0,5,0,5,10,34
2009,Viet Nam,VNM,-,-,76,279,1191,9239,786,961,12532,75,342,1228,11757,483,1370,15255,339299
2009,Sao Tome and Principe,STP,-,-,0,7,0,7,0,0,14,0,0,5,13,0,0,18,32
2009,Sudan,SDN,-,-,29673,41693,23244,73312,6514,85,174521,30002,40631,22450,47607,4272,186,145148,368178
2009,Suriname,SUR,-,-,0,0,0,0,0,0,0,0,0,0,0,0,0,0,44
2009,Slovakia,SVK,-,-,0,0,6,5,5,5,21,0,0,0,8,8,0,16,336
2009,Slovenia,SVN,-,-,0,0,0,7,0,0,7,0,0,0,8,0,0,8,35
2009,Eswatini,SWZ,-,-,0,0,0,0,0,0,0,0,0,0,0,0,0,0,28
2009,Sweden,SWE,-,-,0,0,0,0,0,0,0,0,0,0,0,0,0,0,15
2009,Switzerland,CHE,-,-,0,0,0,5,0,0,5,0,0,0,0,0,0,0,19
2009,Syrian Arab Rep.,SYR,-,-,275,673,797,3148,301,160,5354,277,829,841,4300,328,264,6839,17915
2009,United Rep. of Tanzania,TZA,-,-,0,10,0,11,0,5,26,0,7,5,24,0,9,45,1191
2009,Thailand,THA,-,-,6,34,35,115,5,0,195,6,26,40,82,10,0,164,498
2009,Tajikistan,TJK,-,-,0,11,5,41,19,0,76,5,25,5,43,7,0,85,556
2009,Turkmenistan,TKM,-,-,5,6,9,78,17,0,115,0,9,12,83,14,0,118,734
2009,Timor-Leste,TLS,-,-,0,0,0,0,0,0,0,0,0,0,0,0,0,0,7
2009,Togo,TGO,-,-,512,882,696,3015,72,282,5459,529,911,623,5138,75,359,7635,18363
2009,Tonga,TON,-,-,0,0,0,0,0,0,0,0,0,0,0,0,0,0,5
2009,Trinidad and Tobago,TTO,-,-,0,0,0,0,0,0,0,0,0,0,0,0,0,0,239
2009,Tunisia,TUN,-,-,10,22,7,134,7,222,402,5,29,26,559,15,385,1019,2237
2009,Türkiye,TUR,-,-,975,4311,6414,28532,3434,1722,45388,1041,4646,6747,52735,3178,2878,71225,146378
2009,United Arab Emirates,ARE,-,-,9,15,8,109,16,0,157,19,18,10,136,17,0,200,411
2009,Uganda,UGA,-,-,117,169,144,1010,0,22,1462,33,104,127,1453,162,17,1896,7543
2009,Ukraine,UKR,-,-,69,394,882,5738,2235,52,9370,61,418,973,5826,1867,42,9187,24512
2009,Uruguay,URY,-,-,0,0,0,5,0,0,5,0,0,0,5,0,0,5,183
2009,United States of America,USA,-,-,21,46,30,34,18,0,149,35,54,31,32,7,0,159,2367
2009,Uzbekistan,UZB,-,-,24,87,131,845,107,36,1230,39,127,123,762,83,39,1173,6662
2009,Saint Vincent and the Grenadines,VCT,-,-,0,0,0,0,0,0,0,0,0,0,0,0,0,0,847
2009,Venezuela (Bolivarian Republic of),VEN,-,-,5,22,18,72,0,0,117,5,11,18,109,5,0,148,6216
2009,Western Sahara,ESH,-,-,0,0,0,0,0,8,8,0,0,5,445,0,0,450,116469
2009,Yemen,YEM,-,-,26,43,47,187,8,59,370,19,62,63,250,23,73,490,1927
2009,Zambia,ZMB,-,-,0,0,0,5,0,0,5,0,0,0,7,0,0,7,201
2009,Zimbabwe,ZWE,-,-,59,54,62,228,15,5,423,55,51,76,360,8,0,550,22441
2009,Stateless,XXA,-,-,49,190,261,1386,254,0,2140,59,205,274,2278,307,0,3123,15867
2009,Tibetan,TIB,-,-,0,0,0,0,0,10005,10005,0,0,0,0,0,10010,10010,20080
2009,Unknown ,,-,-,437,963,865,3825,417,1788,8295,430,982,930,5762,515,2637,11256,186680
2010,Afghanistan,AFG,-,-,121996,217895,139463,400185,25497,1517,906553,128660,228779,163129,474226,46692,2953,1044439,3054699
2010,Albania,ALB,-,-,6,40,84,716,62,839,1747,10,43,88,1197,64,971,2373,14771
2010,Algeria,DZA,-,-,17,85,135,512,13,518,1280,25,104,119,1446,28,807,2529,6665
2010,Andorra,AND,-,-,0,0,0,0,0,0,0,0,0,0,0,0,0,0,5
2010,Angola,AGO,-,-,7279,12324,8239,27907,3988,1323,61060,7271,12484,8634,26290,3759,1957,60395,134851
2010,Antigua and Barbuda,ATG,-,-,0,0,0,0,0,0,0,0,0,0,0,0,0,0,28
2010,Egypt,EGY,-,-,25,40,28,128,17,59,297,27,51,42,527,80,129,856,6903
2010,Argentina,ARG,-,-,0,0,10,14,0,0,24,10,0,0,14,0,0,24,553
2010,Armenia,ARM,-,-,23,165,251,1435,169,1661,3704,23,147,244,1462,114,1683,3673,17553
2010,Australia,AUS,-,-,0,0,7,5,7,0,19,0,0,6,8,0,0,14,38
2010,Austria,AUT,-,-,0,0,0,0,0,0,0,0,0,0,0,0,5,5,10
2010,Azerbaijan,AZE,-,-,53,251,334,2946,933,1279,5796,71,267,346,3000,571,1195,5450,16756
2010,Bahrain,BHR,-,-,0,0,0,15,0,0,15,0,0,5,17,0,0,22,81
2010,Barbados,BRB,-,-,0,0,0,0,0,0,0,0,0,0,0,0,0,0,29
2010,Burundi,BDI,-,-,6822,8329,5573,13093,561,329,34707,6820,8243,5763,13807,570,324,35527,84053
2010,Belgium,BEL,-,-,0,0,0,6,0,0,6,0,0,0,0,0,0,0,80
2010,Benin,BEN,-,-,0,19,7,40,0,8,74,0,12,8,128,0,14,162,438
2010,Bangladesh,BGD,-,-,5,14,22,128,7,263,439,10,25,19,799,15,2046,2914,10046
2010,Bahamas,BHS,-,-,0,0,0,0,0,0,0,0,0,0,0,0,0,0,17
2010,Bhutan,BTN,-,-,2954,4029,4535,20549,2283,1120,35470,3142,4199,4759,20912,2752,1155,36919,75062
2010,Burkina Faso,BFA,-,-,5,10,11,39,0,38,103,5,13,5,135,0,54,212,1141
2010,Belarus,BLR,-,-,11,55,75,719,140,235,1235,6,55,83,647,102,308,1201,5735
2010,Bolivia (Plurinational State of),BOL,-,-,5,5,18,50,0,17,95,0,6,12,62,8,25,113,589
2010,Botswana,BWA,-,-,0,0,0,5,0,0,5,0,0,0,0,0,0,0,56
2010,Brazil,BRA,-,-,5,14,18,42,13,15,107,0,14,11,26,0,0,51,991
2010,Bosnia and Herzegovina,BIH,-,-,88,700,1670,17785,6699,3215,30157,83,765,1742,17413,4127,3383,27513,62996
2010,Bulgaria,BGR,-,-,5,12,11,77,8,47,160,5,12,10,51,31,61,170,2558
2010,Belize,BLZ,-,-,0,0,0,0,0,0,0,0,0,0,0,0,0,0,21
2010,Cambodia,KHM,-,-,0,26,5,70,10,7754,7865,0,15,17,89,16,7609,7746,16308
2010,Canada,CAN,-,-,5,6,0,7,5,0,23,5,7,5,6,0,0,23,86
2010,Central African Rep.,CAF,-,-,12234,21121,12452,34974,3036,706,84523,11630,20455,12104,24925,2980,792,72886,164902
2010,Chad,TCD,-,-,647,1022,756,3227,189,3369,9210,666,958,694,4664,218,3938,11138,53713
2010,China,CHN,-,-,90,218,171,1546,67,789,2881,66,209,168,2218,76,1258,3995,184601
2010,Chile,CHL,-,-,0,5,0,123,69,30,227,0,6,0,175,79,44,304,1163
2010,Cameroon,CMR,-,-,250,305,220,995,68,378,2216,202,262,201,895,36,619,2215,14952
2010,Congo,COG,-,-,219,905,825,2603,116,1617,6285,234,902,879,3226,129,1680,7050,20682
2010,Dem. Rep. of the Congo,COD,-,-,40300,48644,29482,90938,6062,12757,228183,40160,48473,29116,81323,4678,13316,217066,476691
2010,Comoros,COM,-,-,0,0,0,0,0,100,100,0,6,0,5,0,224,235,365
2010,Colombia,COL,-,-,1014,3798,3569,21349,988,1034,31752,1122,3951,4018,24137,1451,1181,35860,395579
2010,Costa Rica,CRI,-,-,0,0,0,0,0,0,0,0,0,0,9,0,0,9,352
2010,Cuba,CUB,-,-,14,41,78,727,54,55,969,20,62,100,1181,84,97,1544,7460
2010,Cabo Verde,CPV,-,-,0,0,0,0,0,0,0,0,0,0,5,0,0,5,22
2010,Cyprus,CYP,-,-,0,0,0,5,0,0,5,0,0,0,0,0,0,0,10
2010,Czechia,CZE,-,-,0,0,8,22,32,11,73,0,7,0,42,63,11,123,811
2010,Denmark,DNK,-,-,0,0,0,0,0,0,0,0,0,0,0,0,0,0,6
2010,Djibouti,DJI,-,-,0,14,0,13,5,79,111,5,8,0,27,0,83,123,556
2010,Dominica,DMA,-,-,0,0,0,0,0,0,0,0,0,0,0,0,0,0,51
2010,Dominican Rep.,DOM,-,-,0,5,17,14,0,0,36,0,0,15,14,0,0,29,238
2010,Ecuador,ECU,-,-,12,14,13,40,0,5,84,0,29,10,49,0,0,88,859
2010,Equatorial Guinea,GNQ,-,-,0,0,10,31,0,13,54,0,6,5,42,0,16,69,306
2010,Eritrea,ERI,-,-,7544,11055,8430,35849,2537,11498,76913,8004,11769,10021,45687,3525,13206,92212,222457
2010,Estonia,EST,-,-,0,0,5,27,17,0,49,0,0,5,20,10,5,40,242
2010,Ethiopia,ETH,-,-,2037,2775,1838,11767,441,1639,20497,2095,2892,2026,15257,443,1616,24329,68838
2010,Fiji,FJI,-,-,0,0,0,0,0,0,0,0,0,0,0,0,0,0,1849
2010,Finland,FIN,-,-,0,0,0,0,0,0,0,0,0,0,0,0,0,0,6
2010,France,FRA,-,-,5,0,6,0,0,0,11,0,0,0,0,0,0,0,90
2010,Gabon,GAB,-,-,0,0,5,5,0,10,20,0,0,0,15,0,12,27,167
2010,Gambia,GMB,-,-,6,5,13,41,0,54,119,5,7,11,391,10,53,477,2233
2010,Palestinian,PSE,-,-,6758,8951,5910,17157,1486,117,40379,7507,5991,10996,18930,1278,250,44952,93312
2010,United Kingdom of Great Britain and Northern Ireland,GBR,-,-,0,0,9,0,0,0,9,0,0,0,0,0,0,0,152
2010,Georgia,GEO,-,-,17,75,100,823,178,1168,2361,18,55,117,763,99,1085,2137,10636
2010,Germany,DEU,-,-,0,0,0,0,0,5,5,0,0,0,0,0,0,0,159
2010,Ghana,GHA,-,-,1347,1993,819,4433,473,217,9282,1304,2103,984,4008,516,357,9272,20175
2010,Guinea-Bissau,GNB,-,-,0,0,6,5,0,285,296,0,0,6,52,0,633,691,1117
2010,Greece,GRC,-,-,0,0,0,0,0,0,0,0,0,0,0,0,0,0,52
2010,Grenada,GRD,-,-,0,0,0,0,0,0,0,0,0,0,0,0,0,0,344
2010,Guatemala,GTM,-,-,5,5,17,96,10,0,133,0,10,21,159,19,5,214,5675
2010,Guinea,GIN,-,-,43,49,40,196,0,2110,2438,23,38,32,389,11,2069,2562,11978
2010,Guyana,GUY,-,-,0,0,0,0,0,0,0,0,0,0,0,0,0,0,746
2010,Haiti,HTI,-,-,14,19,14,93,5,1807,1952,7,23,21,161,5,2260,2477,25886
2010,"China, Hong Kong SAR",HKG,-,-,0,0,0,0,0,0,0,0,0,0,0,0,0,0,16
2010,Honduras,HND,-,-,0,16,7,27,0,0,50,0,5,17,54,0,0,76,1300
2010,Croatia,HRV,-,-,11,589,2096,18432,11924,28,33080,14,650,2139,21899,7363,8,32073,65863
2010,Hungary,HUN,-,-,0,0,0,17,11,44,72,0,0,0,32,83,121,236,1435
2010,Iceland,ISL,-,-,0,0,0,0,0,0,0,0,0,0,0,0,0,0,5
2010,Cote d'Ivoire,CIV,-,-,3190,3919,2112,6599,678,826,17324,3076,4162,2304,6278,348,1541,17709,41747
2010,India,IND,-,-,36,45,16,187,20,46,350,30,35,30,2314,100,180,2689,17766
2010,Indonesia,IDN,-,-,69,108,94,350,28,0,649,75,127,106,336,41,0,685,16882
2010,Ireland,IRL,-,-,0,0,0,0,0,0,0,0,0,0,0,0,0,0,7
2010,Iran (Islamic Rep. of),IRN,-,-,445,1233,1363,8730,1509,1117,14397,510,1285,1519,13571,1567,1997,20449,68785
2010,Iraq,IRQ,-,-,62663,105819,91229,403111,60226,2405,725453,66382,113739,95946,476468,20982,39734,813251,1683576
2010,Israel,ISR,-,-,5,19,13,86,68,0,191,6,16,10,88,49,0,169,1290
2010,Italy,ITA,-,-,0,0,0,5,0,5,10,0,0,0,6,0,0,6,45
2010,Jamaica,JAM,-,-,0,0,7,8,0,0,15,0,0,7,0,0,0,7,1055
2010,Jordan,JOR,-,-,5,52,32,189,15,18,311,14,54,56,413,85,23,645,2248
2010,Japan,JPN,-,-,13,16,10,19,5,0,63,20,18,11,11,0,0,60,149
2010,Kazakhstan,KAZ,-,-,5,50,56,605,223,217,1156,10,50,65,558,67,169,919,3631
2010,Kenya,KEN,-,-,320,507,300,971,93,30,2221,362,471,283,732,109,23,1980,8585
2010,Kyrgyzstan,KGZ,-,-,0,31,56,460,217,98,862,5,33,57,415,149,94,753,2748
2010,Kiribati,KIR,-,-,0,0,0,0,0,0,0,0,0,0,0,0,0,0,31
2010,Rep. of Korea,KOR,-,-,12,21,31,41,5,0,110,11,33,27,32,5,0,108,578
2010,Dem. People's Rep. of Korea,PRK,-,-,0,0,0,71,0,10,81,0,5,0,80,0,12,97,915
2010,Kuwait,KWT,-,-,5,13,0,46,10,0,74,0,6,12,90,10,0,118,986
2010,Lao People's Dem. Rep.,LAO,-,-,13,29,28,107,17,3652,3846,25,48,32,151,18,3969,4243,8412
2010,Liberia,LBR,-,-,3099,6009,4992,17426,601,100,32227,3040,6068,4837,16163,727,247,31082,70133
2010,Libya,LBY,-,-,22,28,30,140,20,98,338,20,41,22,319,45,159,606,2297
2010,Saint Lucia,LCA,-,-,0,0,0,0,0,0,0,0,0,0,0,0,0,0,334
2010,Lebanon,LBN,-,-,91,328,537,3940,592,51,5539,137,414,594,5419,578,130,7272,15864
2010,Lesotho,LSO,-,-,0,0,0,0,0,0,0,0,0,0,0,0,0,0,5
2010,Sri Lanka,LKA,-,-,178,439,420,4083,703,42378,48201,182,441,471,9520,853,50767,62234,141064
2010,Lithuania,LTU,-,-,5,8,13,71,30,6,133,0,12,6,66,25,11,120,508
2010,Latvia,LVA,-,-,0,12,17,133,92,5,259,0,12,18,114,69,0,213,712
2010,"China, Macao SAR",MAC,-,-,0,0,0,0,0,0,0,0,0,0,0,0,0,0,8
2010,Madagascar,MDG,-,-,0,5,0,9,0,103,117,0,0,0,0,0,109,109,266
2010,Mauritania,MRT,-,-,2315,3541,2215,6532,604,983,16190,2579,3091,2310,6633,681,3770,19064,37721
2010,North Macedonia,MKD,-,-,36,154,279,2051,82,135,2737,49,166,290,3036,66,172,3779,7880
2010,Rep. of Moldova,MDA,-,-,10,53,141,1338,738,193,2473,10,58,131,1232,533,189,2153,6204
2010,Maldives,MDV,-,-,0,0,0,0,0,0,0,0,0,0,0,0,5,5,16
2010,Mexico,MEX,-,-,0,0,5,13,0,0,18,0,0,8,12,0,6,26,6809
2010,Mali,MLI,-,-,0,8,0,20,0,1897,1925,5,10,5,42,5,722,789,3659
2010,Malaysia,MYS,-,-,0,0,7,7,0,0,14,0,0,0,16,0,5,21,550
2010,Malawi,MWI,-,-,0,0,0,0,0,0,0,0,0,0,0,0,0,0,168
2010,Mongolia,MNG,-,-,5,9,16,114,0,161,305,5,13,10,68,0,111,207,1720
2010,Morocco,MAR,-,-,15,35,29,316,28,47,470,17,35,38,997,33,101,1221,2276
2010,Mozambique,MOZ,-,-,0,15,0,15,0,0,30,0,0,5,67,0,0,72,120
2010,Malta,MLT,-,-,0,0,0,0,0,0,0,0,0,0,0,0,0,0,5
2010,Montenegro,MNE,-,-,45,157,214,1003,36,22,1477,33,128,260,1175,34,14,1644,3243
2010,Mauritius,MUS,-,-,0,0,0,0,0,0,0,0,0,0,0,0,0,0,25
2010,Myanmar,MMR,-,-,10366,11722,9288,40840,2817,535,75568,10631,12208,10438,70063,2903,1122,107365,415662
2010,Namibia,NAM,-,-,0,0,0,5,0,0,5,0,0,0,5,0,0,5,1013
2010,Nepal,NPL,-,-,0,13,12,76,0,20,121,5,16,13,261,5,62,362,5883
2010,Netherlands,NLD,-,-,9,0,0,0,0,0,9,0,0,0,0,0,0,0,52
2010,Niger,NER,-,-,6,16,8,32,0,19,81,5,5,11,147,0,41,209,794
2010,Nicaragua,NIC,-,-,12,27,40,304,31,0,414,17,36,41,419,20,0,533,1426
2010,Nigeria,NGA,-,-,120,387,407,1419,51,371,2755,119,465,367,2397,98,410,3856,15645
2010,New Zealand,NZL,-,-,0,0,5,0,0,0,5,0,0,6,0,0,0,6,11
2010,Oman,OMN,-,-,0,5,0,10,0,0,15,0,7,0,15,5,0,27,62
2010,Pakistan,PAK,-,-,107,324,296,1794,228,148,2897,124,313,301,3901,381,387,5407,39979
2010,Panama,PAN,-,-,0,0,0,8,0,0,8,0,0,0,10,0,0,10,94
2010,Paraguay,PRY,-,-,0,0,0,7,0,0,7,0,0,0,7,0,0,7,86
2010,Peru,PER,-,-,5,14,38,335,12,122,526,6,24,57,508,35,163,793,5834
2010,Philippines,PHL,-,-,0,6,15,111,20,0,152,0,6,13,46,11,0,76,963
2010,Papua New Guinea,PNG,-,-,0,0,0,0,0,0,0,0,0,0,0,0,0,0,87
2010,Poland,POL,-,-,12,35,45,208,61,117,478,11,48,40,215,88,164,566,1758
2010,Portugal,PRT,-,-,0,5,0,0,0,0,5,0,5,0,0,0,0,5,29
2010,Qatar,QAT,-,-,0,5,0,30,5,0,40,6,5,0,46,0,0,57,109
2010,Romania,ROU,-,-,6,19,17,164,110,108,424,5,18,10,161,79,139,412,3926
2010,South Africa,ZAF,-,-,0,5,5,13,0,0,23,0,0,5,24,10,0,39,374
2010,Russian Federation,RUS,-,-,362,1166,1387,11818,7886,6534,29153,362,1278,1491,10435,5526,6598,25690,111944
2010,Rwanda,RWA,-,-,7731,9493,10972,18368,918,2193,49675,8374,10299,14141,20590,1063,1902,56369,115519
2010,El Salvador,SLV,-,-,0,11,19,223,35,0,288,0,7,25,294,69,0,395,4978
2010,Saudi Arabia,SAU,-,-,5,22,9,96,19,0,151,10,16,8,163,21,0,218,659
2010,Serbia and Kosovo: S/RES/1244 (1999),SRB,-,-,1594,6050,9370,42843,2999,5728,68584,1764,6386,9655,55035,2970,6832,82642,183284
2010,Senegal,SEN,-,-,1408,1631,882,3561,473,250,8205,1431,1703,960,2543,202,452,7291,16255
2010,Seychelles,SYC,-,-,0,0,0,0,0,0,0,0,0,0,0,0,0,0,47
2010,Singapore,SGP,-,-,0,0,0,8,0,0,8,0,0,0,0,0,0,0,74
2010,Sierra Leone,SLE,-,-,40,87,121,312,28,195,783,47,126,120,744,17,478,1532,11261
2010,Solomon Islands,SLB,-,-,0,0,0,0,0,0,0,0,0,0,0,0,0,0,75
2010,Somalia,SOM,-,-,42527,62763,40066,155551,8175,694,309776,43955,66492,48250,189965,7434,979,357075,770141
2010,Spain,ESP,-,-,0,13,0,0,0,0,13,0,0,0,0,0,5,5,41
2010,Viet Nam,VNM,-,-,62,240,892,9316,823,148790,160123,74,275,899,12030,527,162942,176747,338707
2010,Saint Kitts and Nevis,KNA,-,-,0,0,0,0,0,0,0,0,0,0,0,0,0,0,10
2010,Sao Tome and Principe,STP,-,-,0,0,7,7,0,0,14,0,0,5,13,0,0,18,32
2010,Sudan,SDN,-,-,30109,41521,30076,82128,7485,335,191654,30541,40706,29459,52910,4999,1648,160263,387265
2010,Suriname,SUR,-,-,0,0,0,0,0,0,0,0,0,0,0,0,0,0,24
2010,Slovakia,SVK,-,-,0,0,5,8,0,5,18,0,0,0,7,6,0,13,157
2010,Slovenia,SVN,-,-,0,0,0,7,0,0,7,0,0,0,7,0,0,7,35
2010,Eswatini,SWZ,-,-,0,0,0,0,0,0,0,0,0,0,0,0,0,0,32
2010,Sweden,SWE,-,-,0,0,0,0,0,0,0,0,5,0,0,0,0,5,23
2010,Switzerland,CHE,-,-,0,0,0,5,0,0,5,0,0,0,0,0,0,0,20
2010,Syrian Arab Rep.,SYR,-,-,267,697,770,3231,310,259,5534,259,715,848,4203,305,573,6903,18451
2010,United Rep. of Tanzania,TZA,-,-,0,5,5,13,0,9,32,5,0,0,29,0,25,59,1135
2010,Thailand,THA,-,-,5,13,27,70,5,0,120,7,15,18,44,6,0,90,351
2010,Tajikistan,TJK,-,-,0,10,6,30,19,18,83,5,24,14,37,8,22,110,573
2010,Turkmenistan,TKM,-,-,0,10,6,69,23,10,118,0,9,12,79,12,6,118,723
2010,Timor-Leste,TLS,-,-,0,0,0,0,0,0,0,0,0,0,0,0,0,0,8
2010,Togo,TGO,-,-,556,865,719,2992,74,517,5723,556,894,649,4995,73,834,8001,18308
2010,Tonga,TON,-,-,0,0,0,0,0,0,0,0,0,0,0,0,0,0,5
2010,Trinidad and Tobago,TTO,-,-,0,0,0,0,0,0,0,0,0,0,0,0,0,0,252
2010,Tunisia,TUN,-,-,7,23,18,142,7,252,449,5,30,25,559,20,560,1199,2159
2010,Türkiye,TUR,-,-,1850,4385,6509,27856,4201,4707,49508,2075,4621,6896,51650,4227,10670,80139,146785
2010,United Arab Emirates,ARE,-,-,16,8,6,113,29,0,172,11,9,14,146,15,0,195,418
2010,Uganda,UGA,-,-,51,87,90,321,15,508,1072,65,87,82,455,22,528,1239,6421
2010,Ukraine,UKR,-,-,62,360,833,6070,2525,435,10285,50,389,914,6187,2062,368,9970,25102
2010,Uruguay,URY,-,-,0,0,0,5,0,0,5,0,0,0,0,5,5,10,185
2010,United States of America,USA,-,-,21,50,34,50,21,0,176,27,54,36,44,11,0,172,3019
2010,Uzbekistan,UZB,-,-,8,48,108,846,138,207,1355,18,93,109,782,99,162,1263,8841
2010,Saint Vincent and the Grenadines,VCT,-,-,0,0,0,0,0,0,0,0,0,0,0,0,0,0,946
2010,Venezuela (Bolivarian Republic of),VEN,-,-,6,18,29,74,0,0,127,7,13,13,125,5,0,163,6697
2010,Western Sahara,ESH,-,-,0,0,0,7,0,0,7,0,0,0,394,0,10,404,116411
2010,Yemen,YEM,-,-,22,58,46,197,10,68,401,22,76,70,285,25,79,557,2070
2010,Zambia,ZMB,-,-,0,0,0,7,0,0,7,0,0,0,7,0,0,7,221
2010,Zimbabwe,ZWE,-,-,0,14,0,50,0,12,76,0,14,5,50,0,20,89,24080
2010,Stateless,XXA,-,-,61,152,241,1405,259,46,2164,74,175,271,2281,317,81,3199,16914
2010,Tibetan,TIB,-,-,0,0,0,0,0,0,0,0,0,0,0,0,16,16,15081
2010,Unknown ,,-,-,381,910,861,3836,475,2274,8737,378,927,843,5822,541,3271,11782,167115
2011,Afghanistan,AFG,-,-,134325,187999,129508,350095,24047,1221,827195,142602,198988,153084,388828,43580,2435,929517,2664423
2011,Albania,ALB,-,-,5,43,81,775,75,870,1849,5,41,100,1257,75,1052,2530,13552
2011,Algeria,DZA,-,-,12,88,112,518,12,541,1283,18,93,120,1415,35,818,2499,6093
2011,Andorra,AND,-,-,0,0,0,0,0,0,0,0,0,0,0,0,0,0,5
2011,Angola,AGO,-,-,6655,11963,7960,26965,3910,1348,58801,6693,12125,8409,25192,3703,1965,58087,128657
2011,Antigua and Barbuda,ATG,-,-,0,0,0,6,0,0,6,0,0,0,6,0,0,6,32
2011,Egypt,EGY,-,-,20,52,46,175,35,77,405,25,57,59,558,95,161,955,7922
2011,Argentina,ARG,-,-,0,0,11,16,5,0,32,0,5,0,16,0,5,26,506
2011,Armenia,ARM,-,-,21,130,252,1496,194,1710,3803,28,156,247,1571,121,1718,3841,16491
2011,Australia,AUS,-,-,0,0,7,6,7,0,20,0,6,0,7,0,0,13,38
2011,Austria,AUT,-,-,0,0,0,0,0,0,0,0,5,0,0,0,0,5,10
2011,Azerbaijan,AZE,-,-,48,224,344,2817,904,1300,5637,65,256,320,2856,589,1211,5297,16168
2011,Bahrain,BHR,-,-,0,0,0,6,5,0,11,0,0,0,15,5,0,20,213
2011,Barbados,BRB,-,-,0,6,0,14,0,0,20,0,9,0,8,0,0,17,42
2011,Burundi,BDI,-,-,7547,9631,7557,18114,996,336,44181,7694,10117,7721,19741,1146,324,46743,101282
2011,Belgium,BEL,-,-,0,0,0,0,0,0,0,0,6,0,0,0,0,6,88
2011,Benin,BEN,-,-,0,22,11,47,0,15,95,0,11,6,134,0,16,167,460
2011,Bangladesh,BGD,-,-,5,19,29,154,7,287,501,15,30,18,815,26,2220,3124,10047
2011,Bahamas,BHS,-,-,0,0,0,5,0,0,5,0,0,0,5,0,0,5,184
2011,Bhutan,BTN,-,-,2252,3143,3383,15191,1818,1153,26940,2320,3329,3622,15507,2249,1202,28229,57980
2011,Burkina Faso,BFA,-,-,0,6,5,55,0,49,115,0,12,6,135,0,58,211,1262
2011,Belarus,BLR,-,-,9,48,76,761,151,230,1275,5,48,88,680,114,293,1228,5916
2011,Bolivia (Plurinational State of),BOL,-,-,5,5,18,46,5,19,98,0,6,7,85,13,25,136,615
2011,Botswana,BWA,-,-,0,5,0,54,0,0,59,0,5,0,10,0,0,15,88
2011,Brazil,BRA,-,-,5,15,16,63,15,13,127,0,10,15,34,0,0,59,1040
2011,Bosnia and Herzegovina,BIH,-,-,68,531,1347,15867,6348,3133,27294,56,585,1409,15862,3919,3322,25153,58572
2011,Bulgaria,BGR,-,-,5,11,19,79,8,43,165,5,12,8,72,35,61,193,2322
2011,Belize,BLZ,-,-,0,0,0,0,0,0,0,0,0,0,0,0,0,0,29
2011,Cambodia,KHM,-,-,0,19,12,85,15,7120,7251,0,20,15,120,9,7118,7282,15201
2011,Canada,CAN,-,-,5,5,0,6,5,0,21,5,5,5,7,5,0,27,108
2011,Central African Rep.,CAF,-,-,11886,22312,13456,35179,2167,280,85280,11873,22368,13081,24478,2435,362,74597,162861
2011,Chad,TCD,-,-,602,1083,705,2220,207,3328,8145,623,1038,665,2824,203,3854,9207,42619
2011,China,CHN,-,-,107,278,217,2492,160,942,4196,89,264,249,3325,165,1510,5602,190369
2011,Chile,CHL,-,-,7,0,5,122,76,70,280,0,0,9,161,83,76,329,1182
2011,Cameroon,CMR,-,-,259,307,232,1101,68,412,2379,203,273,223,980,36,679,2394,15149
2011,Congo,COG,-,-,99,224,234,533,5,1659,2754,127,200,322,807,25,1666,3147,12836
2011,Dem. Rep. of the Congo,COD,-,-,37116,52397,33819,96539,6817,6096,232784,37226,51838,33709,84686,5131,6854,219444,491470
2011,Comoros,COM,-,-,0,0,0,0,0,122,122,0,6,0,5,0,224,235,420
2011,Colombia,COL,-,-,532,2115,2352,13122,658,1277,20056,628,2318,2693,15155,975,1446,23215,395950
2011,Costa Rica,CRI,-,-,0,0,8,5,0,0,13,0,0,8,0,0,0,8,332
2011,Cuba,CUB,-,-,14,46,87,867,82,59,1155,20,66,103,1418,110,93,1810,7845
2011,Cabo Verde,CPV,-,-,0,0,0,0,0,0,0,0,0,0,5,0,0,5,22
2011,Cyprus,CYP,-,-,0,0,0,5,0,0,5,0,0,0,0,0,0,0,10
2011,Czechia,CZE,-,-,0,8,9,40,35,23,115,5,15,0,56,63,27,166,758
2011,Denmark,DNK,-,-,0,0,0,0,0,0,0,0,0,0,0,0,0,0,6
2011,Djibouti,DJI,-,-,12,23,12,55,0,90,192,13,21,8,48,0,91,181,595
2011,Dominica,DMA,-,-,0,0,0,0,0,0,0,0,0,0,0,0,0,0,49
2011,Dominican Rep.,DOM,-,-,0,5,13,20,0,0,38,0,5,8,25,0,0,38,239
2011,Ecuador,ECU,-,-,10,21,18,55,0,14,118,9,36,17,64,0,18,144,912
2011,Equatorial Guinea,GNQ,-,-,0,0,5,20,0,14,39,0,6,0,32,5,16,59,261
2011,Eritrea,ERI,-,-,8394,11923,8967,39458,2663,9169,80574,8996,12668,10803,53038,3718,11129,100352,251941
2011,Estonia,EST,-,-,0,0,5,25,15,5,50,0,0,5,16,11,10,42,225
2011,Ethiopia,ETH,-,-,1942,2760,1688,11672,323,1631,20016,1991,2846,2009,14214,396,1573,23029,70601
2011,Fiji,FJI,-,-,0,0,0,8,0,0,8,0,0,5,12,0,0,17,1576
2011,Finland,FIN,-,-,0,0,0,0,0,0,0,0,0,0,0,0,0,0,6
2011,France,FRA,-,-,0,0,7,0,0,0,7,0,9,0,0,0,0,9,92
2011,Gabon,GAB,-,-,0,0,6,5,0,21,32,0,0,0,13,0,13,26,180
2011,Gambia,GMB,-,-,7,13,15,55,0,69,159,5,6,5,392,10,63,481,2572
2011,Palestinian,PSE,-,-,6802,8989,5963,17350,1490,92,40686,7534,6024,10993,19321,1302,228,45402,94141
2011,United Kingdom of Great Britain and Northern Ireland,GBR,-,-,0,5,0,5,0,0,10,0,5,7,0,0,0,12,150
2011,Georgia,GEO,-,-,19,69,122,849,196,1160,2415,13,64,115,825,119,1119,2255,10115
2011,Germany,DEU,-,-,0,0,0,5,0,10,15,0,0,0,0,0,5,5,169
2011,Ghana,GHA,-,-,1400,1991,814,4409,479,218,9311,1357,2121,981,4026,561,351,9397,20333
2011,Guinea-Bissau,GNB,-,-,7,0,5,10,0,282,304,0,0,0,54,0,642,696,1118
2011,Greece,GRC,-,-,0,0,5,0,0,0,5,0,0,0,5,0,0,5,54
2011,Grenada,GRD,-,-,0,0,6,17,0,0,23,0,0,0,0,0,0,0,325
2011,Guatemala,GTM,-,-,0,29,30,181,11,5,256,0,24,40,247,20,17,348,6087
2011,Guinea,GIN,-,-,36,63,55,256,0,2751,3161,32,55,40,449,11,2420,3007,13164
2011,Guyana,GUY,-,-,0,0,6,37,0,0,43,0,0,5,17,0,0,22,768
2011,Haiti,HTI,-,-,65,206,269,1632,78,1854,4104,44,185,214,1274,26,2366,4109,33652
2011,"China, Hong Kong SAR",HKG,-,-,0,0,0,0,0,0,0,0,0,0,0,0,0,0,14
2011,Honduras,HND,-,-,5,21,31,109,0,0,166,0,12,28,146,0,0,186,1967
2011,Croatia,HRV,-,-,12,473,1705,17246,11598,61,31095,9,540,1741,20470,7251,53,30064,62653
2011,Hungary,HUN,-,-,8,13,6,83,13,43,166,10,8,16,80,91,120,325,1234
2011,Cote d'Ivoire,CIV,-,-,13911,17117,9567,30453,2944,886,74878,13666,18787,10674,25524,1685,1396,71732,154818
2011,India,IND,-,-,48,64,50,324,35,47,568,39,58,57,2467,125,177,2923,16226
2011,Indonesia,IDN,-,-,69,110,99,370,29,6,683,75,134,105,349,39,0,702,16069
2011,Ireland,IRL,-,-,0,0,0,0,0,0,0,0,0,0,0,0,0,0,7
2011,Iran (Islamic Rep. of),IRN,-,-,474,1247,1416,9555,1613,1157,15462,554,1338,1546,14746,1690,2048,21922,72366
2011,Iraq,IRQ,-,-,55995,96165,78414,356778,55186,2698,645236,60088,101012,83631,347465,50168,3616,645980,1428306
2011,Israel,ISR,-,-,6,16,25,108,69,0,224,7,13,28,113,48,0,209,1323
2011,Italy,ITA,-,-,0,0,0,0,0,5,5,0,0,0,9,0,0,9,57
2011,Jamaica,JAM,-,-,0,6,16,130,0,0,152,5,8,6,96,0,5,120,1248
2011,Jordan,JOR,-,-,6,38,39,213,21,22,339,13,56,54,445,93,26,687,2242
2011,Japan,JPN,-,-,17,24,10,26,0,0,77,20,26,11,10,0,0,67,176
2011,Kazakhstan,KAZ,-,-,5,41,54,607,231,225,1163,5,47,63,553,85,171,924,3497
2011,Kenya,KEN,-,-,318,496,340,1079,104,38,2375,342,500,284,807,109,23,2065,8731
2011,Kyrgyzstan,KGZ,-,-,0,26,61,519,246,110,962,5,26,57,450,165,102,805,3163
2011,Kiribati,KIR,-,-,0,0,0,0,0,0,0,0,0,0,0,0,0,0,31
2011,Rep. of Korea,KOR,-,-,6,12,29,49,0,0,96,7,25,17,28,5,0,82,508
2011,Dem. People's Rep. of Korea,PRK,-,-,7,0,0,91,5,13,116,0,5,8,92,0,18,123,1046
2011,Kuwait,KWT,-,-,5,9,5,71,13,0,103,5,0,18,110,13,5,151,1112
2011,Lao People's Dem. Rep.,LAO,-,-,0,5,0,65,11,3612,3693,0,14,0,100,13,3943,4070,8086
2011,Liberia,LBR,-,-,1965,5349,4355,17909,749,94,30421,1935,5510,4398,17726,759,177,30505,66779
2011,Libya,LBY,-,-,21,31,20,149,23,80,324,23,38,25,401,49,150,686,4372
2011,Saint Lucia,LCA,-,-,7,19,17,196,0,0,239,8,21,25,83,0,0,137,432
2011,Lebanon,LBN,-,-,92,292,466,3721,633,58,5262,92,362,507,5188,626,143,6918,15004
2011,Lesotho,LSO,-,-,0,0,0,0,0,0,0,0,0,0,0,0,0,0,5
2011,Sri Lanka,LKA,-,-,179,453,418,4063,824,41812,47749,182,467,468,9780,968,50459,62324,136602
2011,Lithuania,LTU,-,-,5,11,17,66,35,6,140,0,11,7,71,28,24,141,523
2011,Latvia,LVA,-,-,0,18,11,130,93,29,281,0,10,24,116,67,21,238,706
2011,"China, Macao SAR",MAC,-,-,0,0,0,0,0,0,0,0,0,0,0,0,0,0,8
2011,Madagascar,MDG,-,-,5,0,0,7,0,105,117,0,0,0,10,0,118,128,287
2011,Mauritania,MRT,-,-,3337,4171,2243,6213,559,1016,17539,3553,4143,2204,5492,553,3852,19797,39919
2011,North Macedonia,MKD,-,-,27,132,249,2063,98,151,2720,44,150,250,3107,73,178,3802,7677
2011,Monaco,MCO,-,-,0,0,0,0,0,0,0,0,0,0,0,0,0,0,5
2011,Rep. of Moldova,MDA,-,-,5,47,115,1322,770,195,2454,5,46,120,1227,566,192,2156,6261
2011,Maldives,MDV,-,-,0,0,0,0,0,0,0,0,0,0,0,0,5,5,21
2011,Mexico,MEX,-,-,57,110,104,637,6,0,914,53,122,99,487,0,6,767,7471
2011,Mali,MLI,-,-,0,7,0,19,0,2268,2294,0,5,10,40,5,832,892,4289
2011,Malaysia,MYS,-,-,0,0,6,16,0,6,28,0,0,0,16,0,0,16,531
2011,Malawi,MWI,-,-,0,0,0,7,0,0,7,0,0,0,5,0,0,5,216
2011,Mongolia,MNG,-,-,5,7,16,133,0,177,338,11,12,10,82,0,123,238,1982
2011,Morocco,MAR,-,-,10,36,26,343,34,45,494,7,39,23,971,36,114,1190,2305
2011,Mozambique,MOZ,-,-,0,5,13,14,0,5,37,0,0,6,79,0,7,92,147
2011,Malta,MLT,-,-,0,0,0,0,0,0,0,0,0,0,0,0,0,0,5
2011,Montenegro,MNE,-,-,28,152,206,1198,59,26,1669,35,124,257,1409,47,24,1896,3699
2011,Mauritius,MUS,-,-,0,0,0,0,0,0,0,0,0,0,0,0,0,0,36
2011,Myanmar,MMR,-,-,10328,11416,8613,40799,2838,598,74592,10649,11798,9555,72187,2969,1247,108405,414615
2011,Namibia,NAM,-,-,38,60,35,139,0,0,272,47,70,32,584,17,0,750,1067
2011,Nepal,NPL,-,-,0,18,7,161,7,21,214,0,22,22,404,5,66,519,6845
2011,Netherlands,NLD,-,-,0,6,0,0,0,0,6,0,5,0,5,0,0,10,61
2011,Niger,NER,-,-,5,17,5,42,0,43,112,0,8,15,146,0,59,228,805
2011,Nicaragua,NIC,-,-,12,27,40,322,31,0,432,17,36,36,428,25,0,542,1464
2011,Nigeria,NGA,-,-,239,588,493,2120,82,412,3934,237,632,431,2872,94,414,4680,17140
2011,Niue,NIU,-,-,0,0,0,0,0,0,0,0,0,0,0,0,0,0,7
2011,Norway,NOR,-,-,0,0,0,0,0,0,0,0,0,0,0,0,0,0,5
2011,New Zealand,NZL,-,-,0,0,5,0,0,0,5,0,0,8,0,0,0,8,13
2011,Oman,OMN,-,-,0,5,5,11,0,0,21,0,7,0,14,5,0,26,58
2011,Pakistan,PAK,-,-,115,349,298,2060,296,154,3272,123,377,318,4206,467,429,5920,35948
2011,Panama,PAN,-,-,0,0,5,8,0,0,13,0,0,0,10,0,0,10,98
2011,Paraguay,PRY,-,-,0,0,7,8,0,0,15,0,0,5,7,0,0,12,91
2011,Peru,PER,-,-,5,9,79,544,43,126,806,6,24,72,586,48,168,904,5488
2011,Philippines,PHL,-,-,0,8,14,124,23,0,169,0,5,14,56,14,0,89,945
2011,Papua New Guinea,PNG,-,-,0,0,0,0,0,0,0,0,0,0,0,0,0,0,126
2011,Poland,POL,-,-,8,37,54,215,64,186,564,10,49,40,208,94,241,642,1811
2011,Portugal,PRT,-,-,0,0,0,0,0,0,0,0,5,0,0,0,5,10,29
2011,Qatar,QAT,-,-,0,8,0,27,5,0,40,5,0,0,37,0,0,42,93
2011,Romania,ROU,-,-,5,17,24,181,105,105,437,0,29,11,193,78,138,449,3422
2011,South Africa,ZAF,-,-,0,10,5,13,0,5,33,0,5,0,30,9,13,57,422
2011,Russian Federation,RUS,-,-,301,1082,1278,11938,8302,7009,29910,316,1133,1398,10523,5781,6992,26143,109783
2011,Rwanda,RWA,-,-,6888,8567,11098,17408,817,2014,46792,7566,10553,14432,18045,983,1760,53339,106832
2011,El Salvador,SLV,-,-,5,26,34,386,40,7,498,0,26,54,475,82,13,650,6725
2011,Saudi Arabia,SAU,-,-,0,31,8,122,19,0,180,16,25,7,174,21,0,243,733
2011,Serbia and Kosovo: S/RES/1244 (1999),SRB,-,-,1222,4623,7877,39674,2934,6064,62394,1306,4936,7991,51094,2998,6633,74958,161664
2011,Senegal,SEN,-,-,1253,1806,1009,3981,513,338,8900,1313,1877,1096,2942,471,300,7999,17710
2011,Seychelles,SYC,-,-,0,0,0,0,0,0,0,0,0,0,0,0,0,0,39
2011,Singapore,SGP,-,-,0,0,0,0,0,0,0,8,0,0,5,0,0,13,65
2011,Sierra Leone,SLE,-,-,55,81,96,373,31,176,812,44,113,96,848,28,289,1418,7985
2011,Solomon Islands,SLB,-,-,0,0,0,0,0,0,0,0,0,0,5,0,0,5,72
2011,Somalia,SOM,-,-,71868,103314,53647,219485,13322,817,462453,73821,109184,63691,251499,12020,1259,511474,1077038
2011,Spain,ESP,-,-,0,13,0,0,0,0,13,0,0,0,0,0,5,5,42
2011,Viet Nam,VNM,-,-,62,212,636,9233,855,148667,159665,63,255,636,12057,545,162815,176371,337828
2011,Saint Kitts and Nevis,KNA,-,-,0,0,0,0,0,0,0,0,7,0,0,0,0,7,7
2011,Sao Tome and Principe,STP,-,-,0,0,7,7,0,0,14,0,0,0,18,0,0,18,32
2011,Sudan,SDN,-,-,39684,55795,38025,99172,8432,301,241409,41421,57659,39089,73608,6045,1760,219582,500004
2011,Suriname,SUR,-,-,0,0,0,0,0,0,0,0,5,0,0,0,0,5,22
2011,Slovakia,SVK,-,-,0,0,5,5,8,68,86,0,0,0,7,7,62,76,271
2011,Slovenia,SVN,-,-,0,0,0,5,0,0,5,0,0,0,5,0,0,5,30
2011,Eswatini,SWZ,-,-,0,0,0,15,0,0,15,0,0,5,5,0,0,10,39
2011,Sweden,SWE,-,-,0,0,0,0,0,0,0,0,5,0,0,0,0,5,23
2011,Switzerland,CHE,-,-,0,0,0,0,5,0,5,0,0,0,0,0,0,0,20
2011,Syrian Arab Rep.,SYR,-,-,294,677,733,3267,329,355,5655,286,700,800,4417,335,682,7220,19931
2011,United Rep. of Tanzania,TZA,-,-,0,15,10,37,0,14,76,0,15,12,46,0,24,97,1154
2011,Turks and Caicos Islands,TCA,-,-,0,0,0,0,0,0,0,0,0,0,0,0,0,0,14
2011,Thailand,THA,-,-,5,16,28,87,6,0,142,5,12,18,45,6,0,86,365
2011,Tajikistan,TJK,-,-,0,13,11,35,20,12,91,5,20,32,40,7,16,120,604
2011,Turkmenistan,TKM,-,-,0,10,5,62,24,5,106,0,7,10,72,15,16,120,711
2011,Timor-Leste,TLS,-,-,0,0,0,0,0,0,0,0,0,0,0,0,0,0,8
2011,Togo,TGO,-,-,593,872,662,2892,68,556,5643,576,888,598,4798,70,868,7798,17853
2011,Tonga,TON,-,-,0,0,0,0,0,0,0,0,0,0,0,0,0,0,7
2011,Trinidad and Tobago,TTO,-,-,0,5,6,29,0,0,40,0,0,8,16,0,0,24,296
2011,Tunisia,TUN,-,-,6,16,27,144,8,193,394,10,23,25,546,23,424,1051,1930
2011,Türkiye,TUR,-,-,1643,4149,5412,27821,3703,4513,47241,1713,4242,5698,50904,3850,10467,76874,139763
2011,United Arab Emirates,ARE,-,-,12,5,8,154,32,0,211,11,13,22,156,19,0,221,484
2011,Uganda,UGA,-,-,56,63,97,334,10,147,707,45,105,78,449,24,167,868,5658
2011,Ukraine,UKR,-,-,39,333,767,6350,2768,436,10693,48,352,807,6465,2260,369,10301,25372
2011,Uruguay,URY,-,-,0,0,0,5,0,0,5,0,0,0,0,9,5,14,183
2011,United States of America,USA,-,-,110,297,77,62,22,0,568,120,321,64,61,12,0,578,3775
2011,Uzbekistan,UZB,-,-,11,98,131,978,161,155,1534,17,123,157,894,117,116,1424,12667
2011,Saint Vincent and the Grenadines,VCT,-,-,7,24,39,279,0,0,349,6,28,22,82,0,0,138,1126
2011,Venezuela (Bolivarian Republic of),VEN,-,-,11,41,33,165,0,0,250,7,27,37,204,5,7,287,7575
2011,Western Sahara,ESH,-,-,0,0,0,9,0,5,14,0,0,0,358,0,19,377,116414
2011,Yemen,YEM,-,-,35,46,63,227,13,79,463,22,90,66,293,26,83,580,2321
2011,Zambia,ZMB,-,-,0,0,0,12,0,0,12,0,0,0,12,0,0,12,234
2011,Zimbabwe,ZWE,-,-,57,93,74,461,28,11,724,65,67,68,622,16,21,859,25033
2011,Stateless,XXA,-,-,65,151,254,1438,295,42,2245,57,200,240,2319,348,80,3244,18170
2011,Tibetan,TIB,-,-,0,0,0,0,0,7500,7500,0,0,0,0,0,7500,7500,15065
2011,Unknown ,,-,-,326,745,727,3555,506,3401,9260,299,724,718,5394,558,4369,12062,145045
2012,Afghanistan,AFG,-,-,102922,188241,128688,361714,24501,1891,807957,108888,197367,150540,411322,43997,6563,918677,2586132
2012,Albania,ALB,-,-,6,32,66,738,81,986,1909,5,35,82,1187,76,1137,2522,12569
2012,Algeria,DZA,-,-,20,89,90,538,10,569,1316,17,75,132,1433,42,825,2524,5657
2012,Andorra,AND,-,-,0,0,0,0,0,0,0,0,0,0,0,0,0,0,6
2012,Angola,AGO,-,-,105,331,337,1814,61,1405,4053,109,353,397,2748,71,2058,5736,19253
2012,Antigua and Barbuda,ATG,-,-,0,0,0,5,0,0,5,0,0,0,7,0,0,7,45
2012,Egypt,EGY,-,-,25,42,48,165,53,111,444,19,47,56,526,112,239,999,10014
2012,Argentina,ARG,-,-,0,0,12,10,5,0,27,0,6,0,11,5,5,27,435
2012,Armenia,ARM,-,-,23,126,271,1648,247,1997,4312,34,146,274,1712,157,2013,4336,15937
2012,Australia,AUS,-,-,0,7,0,5,9,0,21,0,7,0,8,0,0,15,47
2012,Austria,AUT,-,-,0,0,0,0,0,0,0,0,5,0,0,0,5,10,15
2012,Azerbaijan,AZE,-,-,36,223,323,2806,936,1478,5802,55,272,321,2812,607,1359,5426,15541
2012,Bahrain,BHR,-,-,0,0,5,18,0,0,23,0,0,6,20,5,0,31,294
2012,Barbados,BRB,-,-,0,0,0,10,0,0,10,5,0,0,6,0,0,11,50
2012,Burundi,BDI,-,-,4726,6596,5767,12886,943,341,31259,4609,6680,5819,13880,1047,362,32397,73354
2012,Belgium,BEL,-,-,0,0,0,0,0,0,0,0,7,0,0,0,0,7,91
2012,Benin,BEN,-,-,0,18,13,51,0,19,101,0,11,8,123,0,16,158,451
2012,Bangladesh,BGD,-,-,10,16,23,144,7,333,533,11,25,19,804,30,2547,3436,10159
2012,Bahamas,BHS,-,-,0,0,0,0,0,0,0,0,0,9,0,0,0,9,195
2012,Bhutan,BTN,-,-,1808,2547,2483,11503,1462,11,19814,1862,2717,2709,12125,1854,68,21335,41582
2012,Burkina Faso,BFA,-,-,5,5,5,51,0,71,137,0,11,8,125,5,68,217,1458
2012,Belarus,BLR,-,-,8,43,81,772,165,345,1414,10,39,106,711,126,500,1492,6181
2012,Bolivia (Plurinational State of),BOL,-,-,5,5,19,61,5,20,115,0,6,7,75,13,25,126,616
2012,Botswana,BWA,-,-,0,6,5,52,0,0,63,0,0,7,18,0,0,25,125
2012,Brazil,BRA,-,-,0,16,19,59,13,14,121,0,13,21,27,0,0,61,1073
2012,Bosnia and Herzegovina,BIH,-,-,50,426,1132,14340,5465,3072,24485,61,468,1250,14277,3494,3260,22810,51815
2012,Bulgaria,BGR,-,-,5,11,15,79,11,52,173,5,12,6,62,35,71,191,2143
2012,Belize,BLZ,-,-,0,0,0,0,0,0,0,0,0,6,0,0,0,6,35
2012,Cambodia,KHM,-,-,5,18,19,89,10,6510,6651,6,19,18,121,10,6565,6739,14016
2012,Canada,CAN,-,-,5,8,0,8,5,0,26,0,8,8,5,6,0,27,121
2012,Central African Rep.,CAF,-,-,10335,19916,14659,34880,1980,287,82057,10424,19871,14423,25082,2382,367,72549,164567
2012,Chad,TCD,-,-,428,634,487,1543,127,3458,6677,433,614,458,1990,160,3989,7644,39674
2012,China,CHN,-,-,56,200,140,1617,110,1639,3762,56,185,169,2131,128,2519,5188,193449
2012,Chile,CHL,-,-,0,5,0,106,74,70,255,0,0,9,158,83,75,325,1145
2012,Cameroon,CMR,-,-,56,235,124,722,43,422,1602,63,208,118,833,25,751,1998,13360
2012,Congo,COG,-,-,77,173,141,626,8,1705,2730,90,151,149,861,47,1730,3028,12113
2012,Dem. Rep. of the Congo,COD,-,-,38196,56186,41988,89209,6249,6434,238262,38050,55120,42018,78441,4479,7221,225329,509275
2012,Comoros,COM,-,-,0,0,0,0,0,135,135,0,6,0,5,0,273,284,449
2012,Colombia,COL,-,-,415,1940,2294,12798,674,2049,20170,494,2138,2571,14964,1016,2283,23466,394112
2012,Costa Rica,CRI,-,-,0,6,0,0,5,0,11,0,0,7,0,0,0,7,325
2012,Cuba,CUB,-,-,14,44,77,789,71,83,1078,20,70,105,1276,106,172,1749,7722
2012,Cabo Verde,CPV,-,-,0,0,0,0,0,0,0,0,0,0,5,0,0,5,22
2012,Cyprus,CYP,-,-,0,0,0,5,0,0,5,0,0,0,0,0,0,0,10
2012,Czechia,CZE,-,-,0,12,0,29,36,20,97,0,6,7,42,63,26,144,620
2012,Denmark,DNK,-,-,0,0,0,0,0,0,0,0,0,0,0,0,0,0,6
2012,Djibouti,DJI,-,-,18,23,11,56,7,107,222,11,19,11,45,0,104,190,626
2012,Dominica,DMA,-,-,0,0,0,0,0,0,0,0,0,0,0,0,0,0,52
2012,Dominican Rep.,DOM,-,-,0,0,25,25,0,8,58,0,0,9,26,0,0,35,280
2012,Ecuador,ECU,-,-,5,34,12,55,5,14,125,0,25,20,52,5,18,120,848
2012,Equatorial Guinea,GNQ,-,-,0,0,5,23,0,15,43,0,0,5,18,5,16,44,230
2012,Eritrea,ERI,-,-,6824,12296,10116,42957,3679,14363,90235,7306,13201,12527,57855,4725,16696,112310,285356
2012,Estonia,EST,-,-,0,0,5,23,19,5,52,0,0,10,17,9,10,46,455
2012,Ethiopia,ETH,-,-,2821,3714,2486,12397,460,1711,23589,2945,3968,3055,14072,466,1655,26161,74964
2012,Fiji,FJI,-,-,0,0,0,5,0,0,5,0,0,0,0,0,0,0,1314
2012,Finland,FIN,-,-,0,0,0,0,0,0,0,0,0,0,0,0,0,0,5
2012,France,FRA,-,-,0,0,0,0,0,0,0,0,0,7,0,0,0,7,94
2012,Gabon,GAB,-,-,0,8,10,0,0,16,34,0,0,0,11,0,21,32,189
2012,Gambia,GMB,-,-,7,17,10,62,0,75,171,5,6,10,396,15,66,498,3063
2012,Palestinian,PSE,-,-,6780,9103,6241,16978,1439,126,40667,7509,6156,11330,18986,1263,339,45583,94916
2012,United Kingdom of Great Britain and Northern Ireland,GBR,-,-,0,0,7,0,0,0,7,0,0,0,0,0,0,0,150
2012,Georgia,GEO,-,-,16,75,105,851,237,1287,2571,22,47,111,828,146,1242,2396,9266
2012,Germany,DEU,-,-,0,0,0,0,0,10,10,0,0,0,0,0,5,5,174
2012,Ghana,GHA,-,-,1971,2513,1051,5651,604,220,12010,1897,2625,1164,3835,554,357,10432,24269
2012,Guinea-Bissau,GNB,-,-,5,0,0,20,0,296,321,0,0,11,49,0,643,703,1173
2012,Greece,GRC,-,-,0,0,0,0,0,0,0,0,0,0,5,0,0,5,48
2012,Grenada,GRD,-,-,0,0,0,5,0,0,5,0,0,0,0,0,0,0,316
2012,Guatemala,GTM,-,-,14,14,30,130,0,5,193,5,19,27,206,0,17,274,6389
2012,Guinea,GIN,-,-,56,75,47,279,5,3257,3719,27,50,33,481,14,2838,3443,14062
2012,Guyana,GUY,-,-,0,0,0,8,0,0,8,0,0,0,10,0,5,15,800
2012,Haiti,HTI,-,-,51,113,108,612,69,1632,2585,51,87,101,514,29,2083,2865,38559
2012,"China, Hong Kong SAR",HKG,-,-,0,0,0,0,0,0,0,0,0,0,0,0,0,0,18
2012,Honduras,HND,-,-,16,27,30,113,0,0,186,10,23,28,160,0,0,221,2612
2012,Croatia,HRV,-,-,12,472,1708,17378,11617,59,31246,12,536,1726,20611,7259,50,30194,62606
2012,Hungary,HUN,-,-,27,31,31,155,15,39,298,19,37,40,144,83,109,432,1085
2012,Cote d'Ivoire,CIV,-,-,8059,9863,4649,22778,1729,987,48065,7926,9965,5155,18865,1156,1422,44489,100709
2012,India,IND,-,-,45,58,24,254,30,55,466,52,50,33,2266,151,171,2723,14245
2012,Indonesia,IDN,-,-,298,422,349,1285,91,7,2452,307,476,391,1209,113,0,2496,15514
2012,Ireland,IRL,-,-,0,0,0,0,0,0,0,0,0,0,0,0,0,0,7
2012,Iran (Islamic Rep. of),IRN,-,-,455,1216,1374,9586,1723,1391,15745,476,1301,1610,14816,1794,2497,22494,75932
2012,Iraq,IRQ,-,-,24007,45979,39311,168631,23220,2677,303825,24866,48064,43037,177094,24898,3978,321937,746204
2012,Israel,ISR,-,-,0,16,15,96,59,0,186,6,17,14,92,45,5,179,1326
2012,Italy,ITA,-,-,0,0,0,5,0,7,12,0,0,0,6,0,0,6,65
2012,Jamaica,JAM,-,-,0,7,0,73,0,0,80,0,16,11,47,0,6,80,1404
2012,Jordan,JOR,-,-,9,39,33,233,13,21,348,11,53,55,412,111,32,674,2363
2012,Japan,JPN,-,-,12,23,11,18,5,0,69,24,24,10,9,0,0,67,173
2012,Kazakhstan,KAZ,-,-,5,46,49,592,255,338,1285,5,46,53,539,97,296,1036,3567
2012,Kenya,KEN,-,-,375,520,350,1061,118,53,2477,382,495,314,769,119,40,2119,8946
2012,Kyrgyzstan,KGZ,-,-,5,38,63,568,251,159,1084,29,36,61,476,166,154,922,3490
2012,Kiribati,KIR,-,-,0,0,0,0,0,0,0,0,0,0,0,0,0,0,34
2012,Rep. of Korea,KOR,-,-,8,13,25,53,6,0,105,11,24,25,25,6,0,91,555
2012,Dem. People's Rep. of Korea,PRK,-,-,5,7,5,106,10,27,160,9,8,10,97,0,39,163,1126
2012,Kuwait,KWT,-,-,5,11,10,87,17,0,130,6,9,26,150,14,10,215,1189
2012,Lao People's Dem. Rep.,LAO,-,-,0,0,5,47,14,3588,3654,0,0,0,96,12,3917,4025,7981
2012,Liberia,LBR,-,-,440,1397,1328,5479,216,96,8956,475,1335,1398,5797,260,183,9448,23428
2012,Libya,LBY,-,-,57,70,26,407,56,85,701,57,80,58,1436,114,140,1885,5233
2012,Saint Lucia,LCA,-,-,11,14,18,154,0,0,197,6,15,14,68,0,0,103,567
2012,Lebanon,LBN,-,-,73,289,450,3774,687,60,5333,60,327,494,5160,682,148,6871,15100
2012,Lesotho,LSO,-,-,0,0,0,0,0,0,0,0,0,0,0,0,0,0,5
2012,Sri Lanka,LKA,-,-,166,382,424,3742,836,41713,47263,174,406,616,8845,1019,50250,61310,132720
2012,Lithuania,LTU,-,-,0,6,15,71,45,5,142,0,9,9,70,33,21,142,487
2012,Latvia,LVA,-,-,0,11,13,115,98,28,265,0,12,17,112,69,21,231,662
2012,Madagascar,MDG,-,-,0,5,0,8,0,115,128,0,0,0,5,0,124,129,299
2012,Mauritania,MRT,-,-,2673,3379,1874,4855,424,1104,14309,2875,3392,1868,4459,445,3951,16990,33747
2012,North Macedonia,MKD,-,-,40,132,239,2163,112,172,2858,43,157,234,3110,113,196,3853,7582
2012,Monaco,MCO,-,-,0,0,0,0,0,0,0,0,0,0,0,0,0,0,5
2012,Rep. of Moldova,MDA,-,-,0,37,93,1225,805,202,2362,0,42,107,1139,578,203,2069,6148
2012,Maldives,MDV,-,-,0,0,0,0,0,0,0,0,0,0,0,0,0,0,22
2012,Mexico,MEX,-,-,23,49,31,231,0,8,342,27,36,41,185,0,0,289,8438
2012,Mali,MLI,-,-,14082,18467,9032,31517,2577,2552,78227,14068,18545,8607,23752,2644,896,68512,149930
2012,Malaysia,MYS,-,-,0,0,5,18,0,7,30,0,0,0,17,0,0,17,523
2012,Malawi,MWI,-,-,0,0,0,10,0,0,10,0,0,0,0,0,0,0,273
2012,Mongolia,MNG,-,-,5,5,20,130,5,192,357,5,17,13,71,0,133,239,2111
2012,Morocco,MAR,-,-,9,28,31,349,48,62,527,10,33,22,926,47,136,1174,2394
2012,Mozambique,MOZ,-,-,0,0,13,18,0,5,36,0,0,6,82,0,7,95,155
2012,Malta,MLT,-,-,0,0,0,0,0,0,0,0,0,0,0,0,0,0,5
2012,Montenegro,MNE,-,-,30,156,214,1305,69,36,1810,32,121,258,1549,58,25,2043,4052
2012,Mauritius,MUS,-,-,0,0,0,0,0,0,0,0,0,0,0,0,5,5,57
2012,Myanmar,MMR,-,-,10544,11346,8352,40703,2907,717,74569,10912,11756,9426,72014,3031,1398,108537,415363
2012,Namibia,NAM,-,-,36,66,33,143,0,0,278,49,74,37,587,21,0,768,1097
2012,Nepal,NPL,-,-,0,11,11,104,0,22,148,5,11,9,267,6,76,374,7601
2012,Netherlands,NLD,-,-,0,6,0,0,0,0,6,0,7,0,0,0,0,7,69
2012,Niger,NER,-,-,5,12,6,35,0,47,105,0,8,5,159,0,63,235,824
2012,Nicaragua,NIC,-,-,12,27,37,316,31,0,423,17,36,46,417,25,0,541,1526
2012,Nigeria,NGA,-,-,211,527,429,1802,59,490,3518,203,575,391,2611,100,457,4337,18017
2012,Niue,NIU,-,-,0,0,0,0,0,0,0,0,0,0,0,0,0,0,10
2012,Norway,NOR,-,-,0,0,0,0,0,0,0,0,0,0,0,0,0,0,5
2012,New Zealand,NZL,-,-,0,0,6,0,0,0,6,0,0,8,0,0,0,8,19
2012,Oman,OMN,-,-,0,0,0,18,0,0,18,0,9,0,18,0,0,27,62
2012,Pakistan,PAK,-,-,103,344,324,1917,288,182,3158,148,308,353,4214,504,496,6023,49778
2012,Panama,PAN,-,-,0,0,0,13,0,0,13,0,0,0,10,0,0,10,107
2012,Paraguay,PRY,-,-,0,0,8,0,0,0,8,0,0,0,7,0,5,12,101
2012,Peru,PER,-,-,5,9,65,514,39,134,766,6,25,69,575,52,170,897,5207
2012,Philippines,PHL,-,-,5,8,10,140,22,0,185,0,5,16,44,15,0,80,979
2012,Papua New Guinea,PNG,-,-,0,0,0,0,0,0,0,0,0,0,0,0,0,0,172
2012,Poland,POL,-,-,6,37,45,219,71,178,556,9,43,40,199,102,224,617,1638
2012,Portugal,PRT,-,-,0,0,0,0,0,5,5,0,0,0,5,0,0,5,32
2012,Qatar,QAT,-,-,0,8,5,35,6,0,54,0,9,0,45,6,0,60,123
2012,Romania,ROU,-,-,9,19,18,152,100,147,445,0,22,17,178,82,206,505,2802
2012,South Africa,ZAF,-,-,0,10,6,11,0,5,32,0,0,5,22,10,18,55,413
2012,Russian Federation,RUS,-,-,274,965,1261,11816,8661,7589,30566,258,1023,1318,10450,6007,7545,26601,110587
2012,Rwanda,RWA,-,-,5629,11874,7957,18130,760,2048,46398,6284,10206,7720,17750,665,1794,44419,97357
2012,El Salvador,SLV,-,-,10,36,45,312,40,7,450,10,31,40,466,63,13,623,8173
2012,Saudi Arabia,SAU,-,-,0,11,14,114,22,5,166,14,19,15,185,23,0,256,811
2012,Serbia and Kosovo: S/RES/1244 (1999),SRB,-,-,1125,4213,7965,41279,3117,5896,63595,1179,4511,7971,52125,3307,6682,75775,158903
2012,Senegal,SEN,-,-,1215,1948,1162,4157,558,396,9436,1253,1933,1164,3063,527,369,8309,18717
2012,Seychelles,SYC,-,-,5,0,0,0,0,0,5,0,0,0,0,0,0,0,30
2012,Singapore,SGP,-,-,0,0,9,0,0,0,9,0,0,5,0,0,0,5,64
2012,Sierra Leone,SLE,-,-,40,80,81,432,22,184,839,30,107,107,895,24,313,1476,6191
2012,Solomon Islands,SLB,-,-,0,0,0,0,0,0,0,0,0,0,0,0,0,0,60
2012,Somalia,SOM,-,-,74871,111984,61678,227709,13234,1128,490604,77746,116938,67097,265411,12144,1681,541017,1136709
2012,Spain,ESP,-,-,0,10,0,0,0,0,10,0,0,0,5,0,10,15,55
2012,Viet Nam,VNM,-,-,64,198,400,9072,923,148545,159202,62,240,459,12001,590,162763,176115,336936
2012,Saint Kitts and Nevis,KNA,-,-,0,0,0,0,0,0,0,0,0,0,0,0,0,0,10
2012,Sao Tome and Principe,STP,-,-,0,0,6,8,0,0,14,0,0,0,12,5,0,17,31
2012,Sudan,SDN,-,-,47274,60993,43190,120182,10032,355,282026,48585,60394,43045,84857,8370,2092,247343,568934
2012,Suriname,SUR,-,-,0,0,0,0,0,0,0,0,0,0,0,0,0,0,14
2012,South Sudan,SSD,-,-,6200,8527,5744,14414,897,0,35782,6341,8946,6561,8965,252,0,31065,87007
2012,Slovakia,SVK,-,-,0,5,5,5,7,63,85,0,0,0,11,9,63,83,231
2012,Slovenia,SVN,-,-,0,0,0,6,0,0,6,0,0,0,6,0,0,6,32
2012,Eswatini,SWZ,-,-,5,0,0,22,0,0,27,0,0,0,12,0,0,12,59
2012,Sweden,SWE,-,-,0,0,0,0,0,0,0,0,5,0,0,0,0,5,21
2012,Switzerland,CHE,-,-,0,0,0,5,0,0,5,0,0,0,0,0,0,0,16
2012,Syrian Arab Rep.,SYR,-,-,40770,43590,29865,102367,6525,72938,296055,39662,44794,33615,114850,5133,80345,318399,729011
2012,United Rep. of Tanzania,TZA,-,-,5,11,5,26,5,17,69,5,0,5,56,0,26,92,1109
2012,Turks and Caicos Islands,TCA,-,-,0,0,0,0,0,0,0,0,0,0,0,0,0,0,14
2012,Thailand,THA,-,-,0,16,31,86,8,0,141,0,11,20,40,8,0,79,378
2012,Tajikistan,TJK,-,-,5,6,9,36,21,18,95,6,23,21,45,6,25,126,669
2012,Turkmenistan,TKM,-,-,0,10,7,62,27,15,121,0,8,6,70,15,21,120,708
2012,Timor-Leste,TLS,-,-,0,0,0,0,0,0,0,0,0,0,0,0,0,0,8
2012,Togo,TGO,-,-,381,775,534,2694,47,571,5002,402,728,519,3919,64,891,6523,15683
2012,Tonga,TON,-,-,0,0,0,0,0,0,0,0,0,0,0,0,0,0,11
2012,Trinidad and Tobago,TTO,-,-,0,0,0,5,0,0,5,0,0,0,10,0,0,10,335
2012,Tunisia,TUN,-,-,5,17,23,163,10,169,387,10,12,25,517,26,379,969,1918
2012,Türkiye,TUR,-,-,1445,3888,5124,27655,3892,4509,46513,1484,3935,5335,49839,4265,10475,75333,135353
2012,United Arab Emirates,ARE,-,-,13,13,7,180,37,0,250,9,19,15,200,22,0,265,580
2012,Uganda,UGA,-,-,54,79,86,299,21,149,688,70,88,70,392,29,172,821,5588
2012,Ukraine,UKR,-,-,37,273,687,6362,2911,476,10746,39,296,702,6484,2403,433,10357,25248
2012,Uruguay,URY,-,-,0,0,0,0,0,0,0,0,0,0,0,9,0,9,168
2012,United States of America,USA,-,-,19,70,42,48,22,0,201,24,45,32,44,15,0,160,4454
2012,Uzbekistan,UZB,-,-,10,47,114,912,177,244,1504,22,63,118,844,120,237,1404,11593
2012,Saint Vincent and the Grenadines,VCT,-,-,9,23,22,168,0,0,222,6,16,5,59,0,0,86,1315
2012,Venezuela (Bolivarian Republic of),VEN,-,-,6,29,40,125,0,0,200,7,13,26,147,5,7,205,8204
2012,Western Sahara,ESH,-,-,0,0,0,14,0,7,21,0,0,0,338,0,45,383,116451
2012,Yemen,YEM,-,-,14,73,53,252,25,105,522,11,93,86,312,33,127,662,2582
2012,Zambia,ZMB,-,-,0,0,0,8,0,0,8,0,0,0,8,0,0,8,240
2012,Zimbabwe,ZWE,-,-,51,78,60,274,16,13,492,72,62,46,472,9,22,683,22082
2012,Stateless,XXA,-,-,56,157,250,1455,308,103,2329,64,201,241,2369,375,180,3430,19668
2012,Tibetan,TIB,-,-,0,0,0,0,0,7500,7500,0,0,0,0,0,7500,7500,15000
2012,Unknown ,,-,-,328,724,721,3652,537,2567,8529,324,711,738,5538,596,3292,11199,132803
2013,Afghanistan,AFG,-,-,70001,192013,141354,363895,23741,1538,792542,73803,201028,162536,417543,43695,4084,902689,2556483
2013,Albania,ALB,-,-,5,14,26,180,16,1070,1311,6,11,33,235,13,1236,1534,10104
2013,Algeria,DZA,-,-,6,28,32,187,0,599,852,5,20,49,447,16,842,1379,3643
2013,Andorra,AND,-,-,0,0,0,0,0,0,0,0,0,0,0,0,0,0,5
2013,Angola,AGO,-,-,106,266,270,1245,62,1433,3382,108,279,281,1525,89,2017,4299,10274
2013,Antigua and Barbuda,ATG,-,-,0,0,7,0,0,0,7,0,0,0,5,0,0,5,50
2013,Egypt,EGY,-,-,27,66,34,179,68,151,525,28,60,51,195,44,346,724,12804
2013,Argentina,ARG,-,-,0,0,6,5,0,0,11,0,5,0,11,5,5,26,381
2013,Armenia,ARM,-,-,9,30,46,438,113,2033,2669,11,37,47,487,73,1990,2645,11995
2013,Australia,AUS,-,-,0,5,0,0,0,0,5,0,5,6,0,0,0,11,27
2013,Austria,AUT,-,-,0,0,0,0,0,0,0,0,0,0,0,0,0,0,5
2013,Azerbaijan,AZE,-,-,22,79,70,1344,461,1462,3438,19,99,94,1333,288,1322,3155,10808
2013,Bahrain,BHR,-,-,0,0,0,0,0,0,0,0,0,6,5,0,0,11,274
2013,Barbados,BRB,-,-,0,0,0,5,0,0,5,0,0,0,14,0,0,14,63
2013,Burundi,BDI,-,-,5504,7593,6802,10475,1025,322,31721,5045,7685,6453,11624,967,349,32123,72636
2013,Belgium,BEL,-,-,0,0,5,0,0,0,5,0,0,0,0,0,0,0,76
2013,Benin,BEN,-,-,0,14,5,5,0,23,47,0,0,5,15,0,23,43,294
2013,Bangladesh,BGD,-,-,7,18,0,63,5,402,495,12,18,12,183,5,2974,3204,9720
2013,Bahamas,BHS,-,-,0,0,6,0,0,0,6,0,0,0,6,0,0,6,208
2013,Bhutan,BTN,-,-,1487,1897,1701,8745,1126,15,14971,1474,1999,1900,9282,1431,87,16173,31556
2013,Burkina Faso,BFA,-,-,0,0,0,27,0,72,99,0,5,0,34,0,74,113,1578
2013,Belarus,BLR,-,-,0,5,10,86,6,247,354,5,7,23,119,15,302,471,4387
2013,Bolivia (Plurinational State of),BOL,-,-,5,8,20,49,0,20,102,0,6,7,78,15,20,126,594
2013,Botswana,BWA,-,-,0,0,6,7,0,0,13,0,5,0,0,0,0,5,165
2013,Brazil,BRA,-,-,5,15,5,18,0,8,51,6,19,15,14,0,5,59,982
2013,Bosnia and Herzegovina,BIH,-,-,19,187,400,4955,3443,3189,12193,21,182,490,5511,2113,3337,11654,26787
2013,Bulgaria,BGR,-,-,0,5,6,41,16,40,108,0,5,0,70,43,54,172,1875
2013,Belize,BLZ,-,-,0,0,0,0,0,0,0,0,0,0,0,0,0,0,37
2013,Cambodia,KHM,-,-,0,14,5,66,5,6459,6549,0,14,5,59,10,6489,6577,13738
2013,Canada,CAN,-,-,0,9,5,5,0,0,19,0,5,5,5,0,0,15,94
2013,Central African Rep.,CAF,-,-,20599,30359,20717,51620,3500,300,127095,20523,30067,20796,38536,3393,372,113687,252854
2013,Cayman Islands,CYM,-,-,0,0,0,0,0,0,0,0,0,0,0,0,0,0,6
2013,Chad,TCD,-,-,270,463,334,1129,78,3674,5948,271,421,331,1566,125,4204,6918,48618
2013,China,CHN,-,-,84,165,130,1285,44,1323,3031,97,146,130,1787,83,2186,4429,195121
2013,Chile,CHL,-,-,0,5,0,49,59,54,167,0,0,5,72,73,51,201,588
2013,Cameroon,CMR,-,-,34,132,78,495,30,416,1185,40,97,95,513,14,745,1504,11410
2013,Congo,COG,-,-,70,129,121,516,10,1728,2574,73,137,121,723,41,1728,2823,11744
2013,Dem. Rep. of the Congo,COD,-,-,38276,52767,44911,78453,5052,6881,226340,38624,52927,44429,68751,4107,7781,216619,499551
2013,Comoros,COM,-,-,0,0,0,0,0,152,152,0,0,0,0,0,322,322,509
2013,Colombia,COL,-,-,301,1706,2159,11721,679,2350,18916,358,1830,2396,13558,957,2625,21724,396711
2013,Costa Rica,CRI,-,-,0,5,0,5,0,0,10,0,0,5,0,0,0,5,463
2013,Cuba,CUB,-,-,14,52,245,674,72,57,1114,20,65,106,1304,125,105,1725,7453
2013,Cabo Verde,CPV,-,-,0,0,0,0,0,0,0,0,0,0,0,0,0,0,22
2013,Cyprus,CYP,-,-,0,0,0,5,0,0,5,0,0,0,0,0,0,0,10
2013,Czechia,CZE,-,-,0,0,15,133,89,20,257,0,0,22,196,183,17,418,984
2013,Denmark,DNK,-,-,0,0,0,0,0,0,0,0,0,0,0,0,0,0,6
2013,Djibouti,DJI,-,-,6,7,12,42,0,119,186,5,21,6,44,0,111,187,747
2013,Dominica,DMA,-,-,0,0,0,0,0,0,0,0,0,0,0,0,0,0,41
2013,Dominican Rep.,DOM,-,-,0,0,29,18,0,17,64,0,13,5,6,0,0,24,298
2013,Ecuador,ECU,-,-,5,25,13,28,0,13,84,0,19,14,35,0,18,86,711
2013,Equatorial Guinea,GNQ,-,-,0,0,5,10,0,16,31,0,0,0,14,12,17,43,196
2013,Eritrea,ERI,-,-,6737,14102,10396,49022,4005,12471,96733,7294,15046,12074,70068,5025,14219,123726,308210
2013,Estonia,EST,-,-,0,0,0,0,0,8,8,0,0,0,7,0,0,7,349
2013,Ethiopia,ETH,-,-,3009,4009,2377,12411,451,1731,23988,3243,4280,2732,13266,456,1640,25617,77109
2013,Fiji,FJI,-,-,0,0,5,0,0,0,5,0,0,7,0,0,0,7,1109
2013,Finland,FIN,-,-,0,0,0,0,0,0,0,0,0,0,0,0,0,0,5
2013,France,FRA,-,-,0,0,0,0,0,0,0,0,5,0,15,0,0,20,92
2013,Gabon,GAB,-,-,0,0,5,0,0,19,24,0,0,0,10,0,23,33,180
2013,Gambia,GMB,-,-,6,18,5,47,0,88,164,0,8,10,95,0,73,186,3382
2013,Palestinian,PSE,-,-,6915,8994,5975,17648,1559,120,41211,7713,6180,11011,19738,1387,288,46317,96035
2013,United Kingdom of Great Britain and Northern Ireland,GBR,-,-,0,0,0,5,0,0,5,0,0,0,8,0,0,8,140
2013,Georgia,GEO,-,-,5,25,20,242,33,1331,1656,10,24,26,248,25,1283,1616,6787
2013,Germany,DEU,-,-,0,0,0,0,0,9,9,0,0,5,0,0,0,5,164
2013,Ghana,GHA,-,-,2053,2607,1033,4065,522,211,10491,2011,2814,1107,1685,233,351,8201,21048
2013,Guinea-Bissau,GNB,-,-,0,6,0,18,0,301,325,0,0,7,48,0,653,708,1222
2013,Greece,GRC,-,-,0,0,5,0,9,0,14,0,0,0,23,14,0,37,88
2013,Grenada,GRD,-,-,0,0,0,5,0,0,5,0,0,0,6,0,0,6,330
2013,Guatemala,GTM,-,-,6,21,33,138,0,5,203,0,14,36,215,0,18,283,6620
2013,Guinea,GIN,-,-,52,55,54,232,5,3601,3999,17,16,24,299,15,2982,3353,14559
2013,Guyana,GUY,-,-,0,0,0,6,0,0,6,0,0,0,0,0,5,5,800
2013,Haiti,HTI,-,-,45,108,144,548,44,1621,2510,46,103,127,526,37,2120,2959,38644
2013,"China, Hong Kong SAR",HKG,-,-,0,0,0,0,0,0,0,0,0,9,0,0,0,9,24
2013,Honduras,HND,-,-,20,35,28,155,0,0,238,16,35,39,248,0,0,338,3299
2013,Croatia,HRV,-,-,5,399,1458,14107,10111,58,26138,8,425,1347,15451,5678,52,22961,49755
2013,Hungary,HUN,-,-,18,34,23,174,51,35,335,20,32,33,180,175,60,500,1218
2013,Cote d'Ivoire,CIV,-,-,6061,8461,4220,18782,1473,1098,40095,5816,8360,4712,15850,877,1501,37116,85650
2013,India,IND,-,-,53,61,32,100,5,48,299,58,60,33,243,10,173,577,11032
2013,Indonesia,IDN,-,-,298,420,344,1372,85,6,2525,302,479,392,1187,107,0,2467,14775
2013,Ireland,IRL,-,-,0,0,0,0,0,0,0,0,0,0,0,0,0,0,7
2013,Iran (Islamic Rep. of),IRN,-,-,440,1121,1174,8613,1060,1337,13745,491,1263,1379,13462,1440,2377,20412,75061
2013,Iraq,IRQ,-,-,6193,11295,8778,42234,6151,2557,77208,6493,11869,9715,52820,5603,3651,90151,401461
2013,Israel,ISR,-,-,6,10,6,12,0,0,34,6,6,0,23,5,0,40,1026
2013,Italy,ITA,-,-,0,0,0,5,0,7,12,0,0,0,5,0,0,5,64
2013,Jamaica,JAM,-,-,5,6,10,53,0,0,74,0,10,9,46,0,8,73,1501
2013,Jordan,JOR,-,-,5,7,12,110,0,21,155,0,5,23,72,6,29,135,1622
2013,Japan,JPN,-,-,11,21,8,11,0,0,51,29,26,7,5,0,0,67,154
2013,Kazakhstan,KAZ,-,-,0,5,8,69,31,268,381,0,14,15,60,0,208,297,2114
2013,Kenya,KEN,-,-,373,497,359,1005,114,54,2402,389,495,316,756,116,48,2120,8580
2013,Kyrgyzstan,KGZ,-,-,10,33,8,87,5,152,295,21,34,20,93,0,164,332,2299
2013,Kiribati,KIR,-,-,0,0,0,0,0,0,0,0,0,0,0,0,0,0,21
2013,Rep. of Korea,KOR,-,-,8,13,16,23,0,0,60,9,21,20,19,0,0,69,495
2013,Dem. People's Rep. of Korea,PRK,-,-,0,0,0,65,0,26,91,0,0,9,59,0,29,97,1163
2013,Kuwait,KWT,-,-,0,11,10,20,0,0,41,0,12,0,29,0,11,52,971
2013,Lao People's Dem. Rep.,LAO,-,-,0,0,5,7,0,3522,3534,0,0,0,38,5,3895,3938,7736
2013,Liberia,LBR,-,-,343,879,957,4102,124,91,6496,336,901,949,4212,204,175,6777,17548
2013,Libya,LBY,-,-,0,16,14,86,5,83,204,10,22,19,209,5,137,402,3298
2013,Saint Lucia,LCA,-,-,0,9,12,78,0,0,99,7,11,14,36,0,0,68,711
2013,Lebanon,LBN,-,-,6,26,33,195,30,54,344,15,32,38,270,26,128,509,3809
2013,Lesotho,LSO,-,-,0,0,0,0,0,0,0,0,0,0,0,0,0,0,10
2013,Sri Lanka,LKA,-,-,147,327,203,1577,390,41324,43968,147,319,276,5120,243,49744,55849,123074
2013,Lithuania,LTU,-,-,0,0,0,12,0,0,12,0,0,7,9,0,18,34,217
2013,Latvia,LVA,-,-,0,0,0,17,0,21,38,0,6,0,12,0,21,39,228
2013,Madagascar,MDG,-,-,0,10,0,0,0,112,122,0,0,0,0,0,124,124,298
2013,Mauritania,MRT,-,-,2895,3385,1874,4846,424,1173,14597,3112,3390,1865,4440,443,4055,17305,34239
2013,North Macedonia,MKD,-,-,10,29,55,134,9,159,396,19,33,51,133,14,180,430,1622
2013,Monaco,MCO,-,-,0,0,0,0,0,0,0,0,0,0,0,0,0,0,5
2013,Rep. of Moldova,MDA,-,-,0,0,6,79,5,191,281,0,10,10,82,0,194,296,2210
2013,Maldives,MDV,-,-,0,5,0,0,0,0,5,0,0,0,0,0,0,0,30
2013,Mexico,MEX,-,-,6,26,17,111,0,0,160,5,25,28,116,0,10,184,9396
2013,Marshall Islands,MHL,-,-,0,0,0,0,0,0,0,0,0,0,0,0,0,0,5
2013,Mali,MLI,-,-,12906,20728,8203,32791,3470,2792,80890,12984,20377,8115,21866,2853,939,67134,152812
2013,Malaysia,MYS,-,-,0,6,0,5,0,6,17,0,0,0,5,0,0,5,478
2013,Malawi,MWI,-,-,0,5,0,7,0,0,12,0,0,0,5,0,0,5,323
2013,Mongolia,MNG,-,-,0,0,14,59,0,209,282,6,10,16,19,0,141,192,2054
2013,Morocco,MAR,-,-,0,13,11,92,5,65,186,5,8,10,69,5,169,266,1290
2013,Mozambique,MOZ,-,-,0,0,5,12,0,5,22,0,0,0,6,0,7,13,51
2013,Malta,MLT,-,-,0,0,0,0,0,0,0,0,0,0,0,0,0,0,5
2013,Montenegro,MNE,-,-,0,15,17,90,17,36,175,5,11,14,85,5,31,151,542
2013,Mauritius,MUS,-,-,0,0,0,6,0,0,6,0,0,0,0,0,6,6,72
2013,Myanmar,MMR,-,-,9097,8579,6071,34079,1981,604,60411,9510,9047,6907,66975,2128,1550,96117,479594
2013,Namibia,NAM,-,-,35,56,44,164,0,0,299,50,66,40,584,21,0,761,1138
2013,Nepal,NPL,-,-,0,10,5,45,0,28,88,0,7,14,90,0,93,204,8098
2013,Netherlands,NLD,-,-,0,0,0,9,0,0,9,0,0,0,0,0,0,0,59
2013,Niger,NER,-,-,0,5,5,13,0,38,61,0,5,5,33,0,54,97,674
2013,Nicaragua,NIC,-,-,12,27,32,319,31,0,421,17,42,42,418,25,0,544,1530
2013,Nigeria,NGA,-,-,329,405,308,958,65,558,2623,314,384,226,1099,69,465,2557,31173
2013,Niue,NIU,-,-,0,0,0,0,0,0,0,0,0,0,0,0,0,0,14
2013,Norway,NOR,-,-,0,0,0,0,0,0,0,0,0,0,0,5,0,5,15
2013,New Zealand,NZL,-,-,0,0,5,0,0,0,5,0,0,0,5,0,0,5,15
2013,Oman,OMN,-,-,0,0,0,0,0,0,0,0,0,0,0,0,0,0,20
2013,Pakistan,PAK,-,-,163,310,209,1336,228,193,2439,154,346,252,2445,204,627,4028,48676
2013,Panama,PAN,-,-,0,0,7,8,0,0,15,0,0,0,10,0,0,10,99
2013,Paraguay,PRY,-,-,0,0,0,5,0,0,5,0,0,0,7,0,5,12,91
2013,Peru,PER,-,-,5,14,67,616,61,134,897,6,24,76,660,74,173,1013,4762
2013,Philippines,PHL,-,-,0,8,10,21,0,0,39,0,7,8,0,0,0,15,718
2013,Papua New Guinea,PNG,-,-,0,0,0,0,0,0,0,0,0,0,0,0,0,0,219
2013,Poland,POL,-,-,0,12,11,123,98,103,347,0,7,7,291,262,131,698,1428
2013,Portugal,PRT,-,-,0,0,0,0,0,5,5,0,0,0,0,0,0,0,27
2013,Qatar,QAT,-,-,0,0,0,0,0,0,0,0,0,0,0,0,0,0,15
2013,Romania,ROU,-,-,0,10,23,170,48,93,344,9,9,24,270,95,119,526,2331
2013,South Africa,ZAF,-,-,0,9,22,28,0,5,64,0,0,16,20,10,18,64,424
2013,Russian Federation,RUS,-,-,154,461,395,1906,189,7683,10788,144,534,446,1869,117,7572,10682,74310
2013,Rwanda,RWA,-,-,5095,10724,7645,13991,642,2006,40103,5605,9291,7535,13511,566,1771,38279,83943
2013,El Salvador,SLV,-,-,15,32,39,376,42,7,511,27,43,55,526,63,13,727,9634
2013,Saudi Arabia,SAU,-,-,0,10,12,11,0,0,33,6,5,0,7,0,0,18,575
2013,Serbia and Kosovo: S/RES/1244 (1999),SRB,-,-,380,869,1131,5980,1334,6381,16075,387,943,1327,5908,1173,7277,17015,48725
2013,Senegal,SEN,-,-,1312,2062,1205,4246,601,468,9894,1328,2045,1242,3062,519,424,8620,19815
2013,Seychelles,SYC,-,-,0,0,0,0,0,0,0,0,0,0,0,0,0,0,24
2013,Singapore,SGP,-,-,0,0,0,0,0,0,0,0,7,0,0,0,0,7,61
2013,Sierra Leone,SLE,-,-,44,73,85,359,17,188,766,29,74,106,640,16,303,1168,5305
2013,Solomon Islands,SLB,-,-,0,0,0,0,0,0,0,0,0,0,0,0,0,0,60
2013,Somalia,SOM,-,-,69776,114250,64349,238561,11795,1395,500126,70514,118091,68587,240020,11466,2041,510719,1121760
2013,Spain,ESP,-,-,0,5,5,5,0,0,15,0,0,0,7,0,5,12,56
2013,Viet Nam,VNM,-,-,11,40,33,409,132,148357,148982,12,35,43,869,156,162539,163654,314109
2013,Saint Kitts and Nevis,KNA,-,-,0,0,0,0,0,0,0,0,0,0,6,0,0,6,12
2013,Sao Tome and Principe,STP,-,-,0,0,6,8,0,0,14,0,0,0,12,5,0,17,31
2013,Sudan,SDN,-,-,58921,72792,50000,127084,10611,416,319824,60343,71270,47296,93026,8739,2173,282847,648936
2013,Suriname,SUR,-,-,0,0,0,0,0,0,0,0,0,0,0,0,0,0,17
2013,South Sudan,SSD,-,-,7938,11722,7493,19427,1152,11967,59699,8014,12019,8354,13870,380,11968,54605,114468
2013,Slovakia,SVK,-,-,0,0,0,39,14,63,116,0,0,5,48,36,62,151,321
2013,Slovenia,SVN,-,-,0,0,0,5,0,0,5,0,0,0,0,6,0,6,27
2013,Eswatini,SWZ,-,-,0,0,0,11,0,0,11,0,0,5,15,0,0,20,103
2013,Sweden,SWE,-,-,0,0,0,5,0,0,5,0,0,0,0,0,0,0,18
2013,Switzerland,CHE,-,-,0,0,0,0,0,0,0,0,0,0,0,0,0,0,11
2013,Syrian Arab Rep.,SYR,-,-,165630,172642,110980,427308,29237,1105,906902,172835,182145,119107,420680,22892,1979,919638,2468323
2013,United Rep. of Tanzania,TZA,-,-,9,20,9,27,0,22,87,14,16,0,38,0,19,87,1033
2013,Turks and Caicos Islands,TCA,-,-,0,0,0,0,0,0,0,0,0,0,0,0,0,0,15
2013,Thailand,THA,-,-,0,7,22,10,0,0,39,5,5,11,8,0,0,29,220
2013,Tajikistan,TJK,-,-,5,12,5,18,10,17,67,0,27,12,41,0,16,96,657
2013,Turkmenistan,TKM,-,-,0,5,0,9,0,5,19,0,0,5,7,0,15,27,502
2013,Timor-Leste,TLS,-,-,0,0,0,0,0,0,0,0,0,0,0,0,0,0,8
2013,Togo,TGO,-,-,391,332,291,1063,46,561,2684,387,388,310,1857,71,912,3925,10301
2013,Tonga,TON,-,-,0,0,0,0,0,0,0,0,0,0,0,0,0,0,16
2013,Trinidad and Tobago,TTO,-,-,0,0,5,6,0,0,11,0,0,0,0,0,0,0,336
2013,Tunisia,TUN,-,-,0,14,5,38,0,167,224,0,6,11,78,5,362,462,1359
2013,Türkiye,TUR,-,-,1089,2594,2205,10506,2034,4295,22723,1075,2603,2367,14602,1656,10193,32496,66558
2013,United Arab Emirates,ARE,-,-,0,0,0,0,0,0,0,0,0,0,0,0,0,0,84
2013,Uganda,UGA,-,-,319,504,294,882,76,147,2222,352,530,314,447,26,175,1844,8166
2013,Ukraine,UKR,-,-,7,25,28,197,17,415,689,9,39,29,174,9,350,610,5154
2013,Uruguay,URY,-,-,0,0,0,0,0,0,0,0,0,0,0,0,0,0,144
2013,United States of America,USA,-,-,44,172,69,33,5,0,323,36,183,69,38,8,0,334,4755
2013,Uzbekistan,UZB,-,-,10,29,22,119,6,152,338,24,27,31,104,5,127,318,4953
2013,Saint Vincent and the Grenadines,VCT,-,-,5,13,15,70,0,0,103,5,12,12,32,0,0,61,1535
2013,Venezuela (Bolivarian Republic of),VEN,-,-,6,34,28,101,0,8,177,7,21,18,139,5,0,190,8396
2013,Western Sahara,ESH,-,-,0,0,0,21,0,11,32,0,0,0,337,0,80,417,116500
2013,Yemen,YEM,-,-,22,42,34,192,19,84,393,5,52,58,232,23,98,468,2413
2013,Zambia,ZMB,-,-,0,5,0,0,0,0,5,5,0,0,5,0,0,10,230
2013,Zimbabwe,ZWE,-,-,69,86,75,360,16,15,621,77,70,70,554,14,22,807,19719
2013,Stateless,XXA,-,-,21,36,29,246,37,55,424,28,51,50,447,76,88,740,20198
2013,Tibetan,TIB,-,-,0,0,0,0,0,7500,7500,0,0,0,0,0,7500,7500,15065
2013,Curacao ,CUW,-,-,0,0,0,0,0,0,0,0,0,0,0,0,0,0,35
2013,Unknown ,,-,-,160,303,245,1299,397,529,2933,186,315,260,1888,729,1080,4458,107203
2014,Afghanistan,AFG,-,-,50536,178376,138708,355532,20967,1302,745421,53663,187547,154714,406346,39771,3504,845545,2596259
2014,Albania,ALB,-,-,14,18,16,204,17,1272,1541,19,15,27,220,13,1333,1627,10156
2014,Algeria,DZA,-,-,5,22,36,150,0,611,824,10,15,23,294,20,830,1192,3509
2014,Andorra,AND,-,-,0,0,0,0,0,0,0,0,0,0,0,0,0,0,5
2014,Angola,AGO,-,-,99,241,228,1039,54,1426,3087,92,250,258,1589,70,1960,4219,9468
2014,Antigua and Barbuda,ATG,-,-,0,5,0,8,0,0,13,0,0,0,6,0,0,6,53
2014,Egypt,EGY,-,-,40,77,56,188,48,204,613,34,71,60,275,46,522,1008,15899
2014,Argentina,ARG,-,-,0,0,11,5,0,5,21,0,0,0,6,8,0,14,311
2014,Armenia,ARM,-,-,10,29,43,466,131,2064,2743,10,49,46,526,85,2013,2729,11839
2014,Australia,AUS,-,-,0,0,5,0,0,0,5,0,0,6,0,0,0,6,27
2014,Austria,AUT,-,-,0,0,0,0,0,0,0,0,0,0,0,0,0,0,5
2014,Azerbaijan,AZE,-,-,29,70,70,1342,467,1484,3462,32,106,85,1320,287,1345,3175,10508
2014,Bahrain,BHR,-,-,10,5,0,5,0,0,20,0,0,0,22,0,0,22,344
2014,Barbados,BRB,-,-,0,0,0,5,0,0,5,0,0,0,8,0,0,8,82
2014,Burundi,BDI,-,-,4305,7039,5953,12542,1019,1385,32243,4194,7120,5919,13824,1069,2679,34805,72477
2014,Belgium,BEL,-,-,0,0,5,0,0,0,5,0,0,0,0,0,0,0,76
2014,Benin,BEN,-,-,0,6,10,14,0,11,41,0,0,0,25,0,19,44,330
2014,Bangladesh,BGD,-,-,16,22,7,110,0,472,627,23,28,12,312,14,4128,4517,10868
2014,Bahamas,BHS,-,-,0,0,0,5,0,0,5,0,0,0,6,0,5,11,216
2014,Bhutan,BTN,-,-,1132,1480,1258,6401,791,16,11078,1126,1589,1382,6907,1050,98,12152,23633
2014,Burkina Faso,BFA,-,-,0,0,0,16,0,56,72,0,5,6,44,0,51,106,1853
2014,Belarus,BLR,-,-,10,6,18,55,7,240,336,5,5,19,75,9,285,398,4296
2014,Bolivia (Plurinational State of),BOL,-,-,0,12,10,50,0,17,89,0,6,12,81,20,18,137,594
2014,Botswana,BWA,-,-,0,0,0,9,0,0,9,0,0,0,0,0,0,0,234
2014,Brazil,BRA,-,-,5,11,6,10,0,6,38,0,13,13,5,0,14,45,977
2014,Bosnia and Herzegovina,BIH,-,-,25,152,311,4084,2712,3085,10369,26,167,384,4423,1666,3183,9849,21883
2014,Bulgaria,BGR,-,-,0,5,6,6,15,36,68,0,0,5,27,43,47,122,1644
2014,Belize,BLZ,-,-,0,0,0,9,0,0,9,0,0,0,0,0,0,0,42
2014,Cambodia,KHM,-,-,0,11,5,77,0,6144,6237,0,12,5,57,5,6215,6294,13066
2014,Canada,CAN,-,-,0,7,5,7,0,0,19,0,5,5,5,0,0,15,89
2014,Central African Rep.,CAF,-,-,31930,51021,32248,91843,5590,1489,214121,32110,49975,32255,73058,5996,1649,195043,412028
2014,Cayman Islands,CYM,-,-,0,0,0,0,0,0,0,0,0,0,0,0,0,0,6
2014,Chad,TCD,-,-,349,433,643,770,198,3999,6392,336,411,503,1162,272,4292,6976,48236
2014,China,CHN,-,-,149,161,100,1493,65,1585,3553,118,134,106,2218,87,2384,5047,210793
2014,Chile,CHL,-,-,0,6,0,43,58,45,152,0,0,6,81,75,36,198,571
2014,Cameroon,CMR,-,-,19,71,36,395,28,493,1042,22,50,46,464,11,916,1509,10739
2014,Congo,COG,-,-,74,139,104,406,10,4315,5048,65,139,95,589,46,5034,5968,14498
2014,Dem. Rep. of the Congo,COD,-,-,38042,51775,35784,95724,6167,19430,246922,38271,52786,37004,88253,5109,24741,246164,516765
2014,Comoros,COM,-,-,0,0,0,0,0,173,173,0,0,0,0,0,346,346,580
2014,Colombia,COL,-,-,64,166,421,1437,115,2123,4326,68,232,479,2002,110,2461,5352,360291
2014,Costa Rica,CRI,-,-,0,5,0,0,0,0,5,0,0,0,0,0,0,0,414
2014,Cuba,CUB,-,-,5,15,240,320,36,63,679,0,37,62,809,56,103,1067,7497
2014,Cabo Verde,CPV,-,-,0,0,0,0,0,0,0,0,5,0,0,0,0,5,27
2014,Cyprus,CYP,-,-,0,0,0,0,0,0,0,0,0,0,0,0,0,0,10
2014,Czechia,CZE,-,-,0,0,0,141,179,21,341,0,0,0,228,330,17,575,1321
2014,Denmark,DNK,-,-,0,0,0,0,0,0,0,0,0,0,0,0,0,0,11
2014,Djibouti,DJI,-,-,12,11,13,58,5,78,177,10,20,20,54,0,63,167,870
2014,Dominica,DMA,-,-,0,0,0,0,0,0,0,0,0,0,0,0,0,0,35
2014,Dominican Rep.,DOM,-,-,0,0,10,10,0,19,39,0,0,6,15,0,0,21,348
2014,Ecuador,ECU,-,-,5,27,6,22,0,13,73,5,10,6,55,0,16,92,807
2014,Equatorial Guinea,GNQ,-,-,0,0,0,10,0,15,25,0,0,0,14,0,16,30,168
2014,Eritrea,ERI,-,-,7532,16914,12819,63826,4137,7053,112281,7970,18015,14989,98302,5277,9455,154008,363081
2014,Estonia,EST,-,-,0,0,0,0,0,8,8,0,0,0,0,0,6,6,340
2014,Ethiopia,ETH,-,-,2825,3947,2824,12687,429,4994,27706,3096,4147,2936,13452,495,14886,39012,86857
2014,Fiji,FJI,-,-,0,0,0,0,0,0,0,0,0,0,10,0,0,10,927
2014,Finland,FIN,-,-,0,0,0,0,0,0,0,0,0,0,0,0,0,0,5
2014,France,FRA,-,-,0,0,0,0,0,0,0,0,0,0,9,5,0,14,84
2014,Gabon,GAB,-,-,0,0,5,0,0,13,18,5,0,0,5,0,18,28,179
2014,Gambia,GMB,-,-,7,15,0,57,0,103,182,5,10,6,138,0,87,246,5122
2014,Palestinian,PSE,-,-,6856,9103,5916,17909,1574,138,41496,7627,6260,10909,20334,1425,326,46881,97207
2014,United Kingdom of Great Britain and Northern Ireland,GBR,-,-,0,0,0,11,0,0,11,0,0,0,6,0,0,6,137
2014,Georgia,GEO,-,-,5,20,20,208,45,1392,1690,10,26,11,214,17,1337,1615,6687
2014,Germany,DEU,-,-,0,0,0,0,0,8,8,0,0,0,0,0,0,0,170
2014,Ghana,GHA,-,-,2180,2679,1053,4264,544,208,10928,2122,2899,1135,1714,245,334,8449,22116
2014,Guinea-Bissau,GNB,-,-,0,17,0,26,0,294,337,0,0,11,44,0,643,698,1306
2014,Greece,GRC,-,-,0,0,0,5,5,0,10,0,0,0,18,20,0,38,108
2014,Grenada,GRD,-,-,0,0,0,6,0,0,6,0,0,0,0,0,0,0,324
2014,Guatemala,GTM,-,-,6,16,25,129,0,5,181,0,14,25,184,0,10,233,7487
2014,Guinea,GIN,-,-,53,69,40,278,10,2948,3398,16,26,45,373,7,2309,2776,15247
2014,Guyana,GUY,-,-,0,0,0,6,0,0,6,0,0,0,8,0,8,16,700
2014,Haiti,HTI,-,-,24,64,78,402,30,1550,2148,15,53,61,382,36,1973,2520,37147
2014,"China, Hong Kong SAR",HKG,-,-,0,0,0,0,0,0,0,0,0,0,0,0,0,0,25
2014,Honduras,HND,-,-,18,19,40,135,0,0,212,18,39,38,226,0,0,321,4157
2014,Croatia,HRV,-,-,7,331,1194,11526,8014,69,21141,5,368,1097,12582,4584,60,18696,40121
2014,Hungary,HUN,-,-,20,21,16,133,58,24,272,29,30,19,155,167,50,450,1264
2014,Cote d'Ivoire,CIV,-,-,4715,6614,3744,14776,1035,1196,32080,4539,6700,4098,13384,666,1439,30826,71956
2014,India,IND,-,-,47,61,28,88,0,57,281,70,50,27,230,10,168,555,10431
2014,Indonesia,IDN,-,-,5,5,0,488,0,6,504,5,7,14,0,9,0,35,14393
2014,Ireland,IRL,-,-,0,0,0,0,0,0,0,0,0,0,0,0,0,0,7
2014,Iran (Islamic Rep. of),IRN,-,-,397,1129,1808,9615,1175,1286,15410,439,1281,3165,14758,1576,2212,23431,82202
2014,Iraq,IRQ,-,-,5421,10613,11962,29213,3978,2437,63624,5784,11297,11629,41124,3657,2856,76347,369960
2014,Israel,ISR,-,-,0,5,9,6,0,5,25,5,5,0,16,0,0,26,967
2014,Italy,ITA,-,-,0,0,0,6,0,7,13,0,0,0,5,0,0,5,63
2014,Jamaica,JAM,-,-,5,7,5,59,0,5,81,0,6,6,59,0,5,76,1682
2014,Jordan,JOR,-,-,5,11,22,111,5,11,165,0,16,7,73,5,17,118,1711
2014,Japan,JPN,-,-,23,44,13,5,0,0,85,42,62,22,5,0,0,131,257
2014,Kazakhstan,KAZ,-,-,5,5,6,44,25,272,357,5,12,13,42,5,211,288,2219
2014,Kenya,KEN,-,-,285,443,394,1007,136,158,2423,270,462,365,788,124,136,2145,8546
2014,Kyrgyzstan,KGZ,-,-,11,30,13,80,11,151,296,27,37,19,91,0,157,331,2449
2014,Kiribati,KIR,-,-,0,0,0,0,0,0,0,0,0,0,0,0,0,0,5
2014,Rep. of Korea,KOR,-,-,8,16,22,21,0,0,67,15,21,24,19,0,5,84,478
2014,Dem. People's Rep. of Korea,PRK,-,-,0,0,0,46,0,72,118,0,0,0,53,5,80,138,1275
2014,Kuwait,KWT,-,-,0,6,6,13,0,0,25,0,7,5,21,0,9,42,974
2014,Lao People's Dem. Rep.,LAO,-,-,0,0,0,6,5,3411,3422,0,0,0,36,5,3768,3809,7476
2014,Liberia,LBR,-,-,371,754,789,2943,131,96,5084,359,802,763,3075,177,228,5404,13561
2014,Libya,LBY,-,-,18,34,30,90,0,86,258,25,47,25,175,9,149,430,4187
2014,Saint Lucia,LCA,-,-,0,0,5,9,0,0,14,0,0,0,6,0,0,6,921
2014,Lebanon,LBN,-,-,11,26,46,253,35,35,406,16,42,50,566,25,89,788,4262
2014,Lesotho,LSO,-,-,0,0,0,0,0,5,5,0,0,0,0,0,0,0,16
2014,Sri Lanka,LKA,-,-,147,278,169,1514,378,41086,43572,148,264,241,4805,245,50042,55745,121991
2014,Lithuania,LTU,-,-,0,0,0,6,0,0,6,0,0,0,0,0,12,12,182
2014,Latvia,LVA,-,-,0,0,0,5,0,21,26,0,0,0,17,0,20,37,206
2014,"China, Macao SAR",MAC,-,-,0,0,0,0,0,0,0,0,0,0,0,0,5,5,5
2014,Madagascar,MDG,-,-,0,5,0,5,0,103,113,0,0,0,0,0,111,111,279
2014,Mauritania,MRT,-,-,2901,3377,1869,4844,424,1162,14577,3112,3383,1860,4438,443,3896,17132,34103
2014,North Macedonia,MKD,-,-,20,29,60,177,16,163,465,20,45,50,137,21,177,450,1752
2014,Monaco,MCO,-,-,0,0,0,0,0,0,0,0,0,0,0,0,0,0,5
2014,Rep. of Moldova,MDA,-,-,0,5,0,22,5,179,211,0,5,5,16,0,177,203,2230
2014,Maldives,MDV,-,-,0,5,0,0,0,0,5,0,0,0,0,0,0,0,32
2014,Mexico,MEX,-,-,5,5,17,55,0,5,87,0,5,19,34,0,6,64,10672
2014,Marshall Islands,MHL,-,-,0,0,0,0,0,0,0,0,0,0,0,0,0,0,5
2014,Mali,MLI,-,-,10443,19054,7922,29340,2868,3030,72657,10580,18855,7897,18936,2475,910,59653,139249
2014,Malaysia,MYS,-,-,0,7,0,0,0,7,14,0,0,0,0,0,0,0,458
2014,Malawi,MWI,-,-,0,0,0,0,0,10,10,0,0,0,0,0,13,13,356
2014,Mongolia,MNG,-,-,0,5,6,63,0,214,288,10,13,11,31,0,145,210,2162
2014,Morocco,MAR,-,-,10,7,13,83,7,74,194,9,8,13,67,5,177,279,1523
2014,Mozambique,MOZ,-,-,0,0,0,10,0,10,20,0,0,0,7,0,5,12,55
2014,Montenegro,MNE,-,-,0,7,20,98,14,49,188,5,9,19,76,5,42,156,601
2014,Mauritius,MUS,-,-,0,0,0,0,0,5,5,0,0,0,0,0,5,5,91
2014,Myanmar,MMR,-,-,11227,11548,8764,43510,2760,644,78453,11818,12271,9532,74251,2797,1564,112233,479006
2014,Namibia,NAM,-,-,38,54,41,136,0,5,274,51,68,35,557,34,0,745,1250
2014,Nepal,NPL,-,-,0,5,0,28,0,26,59,0,0,6,74,0,87,167,8542
2014,Netherlands,NLD,-,-,0,0,0,5,0,0,5,0,0,0,5,0,0,5,63
2014,Niger,NER,-,-,0,5,10,7,0,17,39,0,5,5,39,0,39,88,728
2014,Nicaragua,NIC,-,-,0,0,0,77,18,0,95,0,0,0,127,7,0,134,1580
2014,Nigeria,NGA,-,-,617,812,357,1534,69,639,4028,568,740,298,1353,92,502,3553,90936
2014,Niue,NIU,-,-,0,0,0,0,0,0,0,0,0,0,0,0,0,0,18
2014,Norway,NOR,-,-,0,0,0,0,0,0,0,0,0,0,0,0,0,0,15
2014,New Zealand,NZL,-,-,0,0,0,0,0,0,0,0,0,0,9,0,0,9,14
2014,Oman,OMN,-,-,0,0,0,0,0,0,0,0,0,0,0,0,5,5,25
2014,Pakistan,PAK,-,-,19862,25786,22622,74192,3102,204,145768,19885,28520,19990,67528,5840,749,142512,335947
2014,Panama,PAN,-,-,0,0,0,0,0,0,0,0,0,0,0,0,0,0,83
2014,Paraguay,PRY,-,-,0,0,0,8,0,0,8,0,0,0,7,0,5,12,87
2014,Peru,PER,-,-,0,0,45,484,64,125,718,0,7,56,536,65,174,838,4333
2014,Philippines,PHL,-,-,0,8,5,29,0,0,42,0,9,0,0,0,0,9,660
2014,Papua New Guinea,PNG,-,-,0,0,0,0,0,0,0,0,0,0,0,0,0,0,285
2014,Poland,POL,-,-,0,5,6,102,101,72,286,0,5,11,241,269,89,615,1306
2014,Portugal,PRT,-,-,0,0,0,0,0,5,5,0,0,0,0,5,0,5,30
2014,Qatar,QAT,-,-,0,0,0,0,0,0,0,0,0,0,0,0,0,0,23
2014,Romania,ROU,-,-,0,13,10,33,35,80,171,0,8,10,64,85,99,266,1917
2014,South Africa,ZAF,-,-,0,13,0,5,0,6,24,0,7,0,10,10,18,45,422
2014,Russian Federation,RUS,-,-,149,475,405,1888,206,7240,10363,153,503,450,1778,123,6781,9788,70552
2014,Rwanda,RWA,-,-,5013,8229,5521,15146,771,2398,37078,5108,7841,5586,16065,815,2409,37824,79396
2014,El Salvador,SLV,-,-,11,18,25,185,36,6,281,21,21,16,238,55,12,363,10968
2014,Saudi Arabia,SAU,-,-,5,0,5,6,0,5,21,5,5,5,25,0,0,40,616
2014,Serbia and Kosovo: S/RES/1244 (1999),SRB,-,-,310,757,966,5854,1375,6329,15591,326,814,1189,5731,1241,7076,16377,45730
2014,Senegal,SEN,-,-,1194,2683,1918,4085,533,476,10889,1154,2843,1812,3153,457,249,9668,23110
2014,Seychelles,SYC,-,-,0,0,0,0,0,5,5,0,0,0,0,0,0,0,23
2014,Singapore,SGP,-,-,0,0,0,0,0,0,0,0,7,0,0,0,0,7,55
2014,Sierra Leone,SLE,-,-,45,71,96,358,17,181,768,34,85,67,610,16,322,1134,4988
2014,Solomon Islands,SLB,-,-,0,0,0,0,0,5,5,0,0,0,0,0,7,7,70
2014,Somalia,SOM,-,-,62598,113081,65918,216387,13274,7974,479232,64927,117458,73165,237643,12410,35061,540664,1106430
2014,Spain,ESP,-,-,0,0,0,5,0,0,5,0,0,5,5,0,5,15,60
2014,Viet Nam,VNM,-,-,10,48,38,385,137,148159,148777,14,36,37,781,165,162279,163312,313420
2014,Saint Kitts and Nevis,KNA,-,-,0,0,0,9,0,0,9,0,0,0,0,0,0,0,20
2014,Sao Tome and Principe,STP,-,-,0,0,5,6,0,0,11,8,0,0,0,0,5,13,24
2014,Sudan,SDN,-,-,59773,75617,53471,135354,11434,479,336128,61553,74983,54619,97874,9401,2570,301000,665956
2014,Suriname,SUR,-,-,0,0,0,0,0,0,0,0,0,0,0,0,0,0,17
2014,South Sudan,SSD,-,-,48996,79464,46142,119600,8584,25268,328054,50362,82674,54375,76627,4268,19637,287943,616206
2014,Slovakia,SVK,-,-,0,8,0,30,15,61,114,5,0,5,41,34,59,144,316
2014,Slovenia,SVN,-,-,0,0,0,0,0,0,0,0,0,0,0,9,0,9,25
2014,Eswatini,SWZ,-,-,0,0,0,0,0,5,5,0,0,0,0,0,7,7,151
2014,Sweden,SWE,-,-,0,0,0,5,0,0,5,0,0,0,0,0,0,0,18
2014,Switzerland,CHE,-,-,0,0,0,0,0,0,0,0,0,0,0,0,0,0,16
2014,Syrian Arab Rep.,SYR,-,-,209153,244322,181554,560371,41407,1770,1238577,217922,257384,191887,516324,32756,2697,1218970,3887490
2014,United Rep. of Tanzania,TZA,-,-,8,13,5,31,0,29,86,8,14,0,45,0,26,93,843
2014,Turks and Caicos Islands,TCA,-,-,0,0,0,0,0,0,0,0,0,0,0,0,0,0,15
2014,Thailand,THA,-,-,0,7,19,18,0,0,44,0,9,15,8,0,0,32,223
2014,Tajikistan,TJK,-,-,5,6,15,25,5,18,74,5,27,19,45,0,18,114,722
2014,Turkmenistan,TKM,-,-,0,0,0,16,0,6,22,5,0,0,10,0,17,32,470
2014,Timor-Leste,TLS,-,-,0,0,0,0,0,0,0,0,0,0,0,0,0,0,13
2014,Togo,TGO,-,-,204,327,233,1047,54,539,2404,212,320,227,1807,86,827,3479,9271
2014,Tonga,TON,-,-,0,0,0,0,0,0,0,0,0,0,0,0,0,0,19
2014,Trinidad and Tobago,TTO,-,-,0,0,0,8,0,0,8,0,0,0,0,0,0,0,371
2014,Tunisia,TUN,-,-,0,16,5,41,0,169,231,0,5,18,83,5,360,471,1476
2014,Türkiye,TUR,-,-,1593,2475,1860,10012,2056,4100,22096,1552,2478,2010,13910,1693,9724,31367,63882
2014,United Arab Emirates,ARE,-,-,0,0,0,0,0,0,0,0,0,0,0,0,0,0,84
2014,Uganda,UGA,-,-,160,264,177,502,38,236,1377,163,271,173,465,21,560,1653,7177
2014,Ukraine,UKR,-,-,14,72,58,299,50,162656,163149,18,70,53,284,29,69881,70335,237617
2014,Uruguay,URY,-,-,0,0,0,0,0,0,0,0,0,0,0,0,0,0,119
2014,United States of America,USA,-,-,16,50,30,13,5,0,114,15,36,27,21,8,0,107,4980
2014,Uzbekistan,UZB,-,-,0,11,26,105,6,149,297,21,13,41,92,5,118,290,4790
2014,Saint Vincent and the Grenadines,VCT,-,-,0,0,5,25,0,0,30,8,0,0,7,0,0,15,1736
2014,Venezuela (Bolivarian Republic of),VEN,-,-,5,14,17,51,0,6,93,0,14,0,84,0,6,104,8009
2014,Western Sahara,ESH,-,-,0,0,0,18,0,23,41,0,0,0,228,0,169,397,116478
2014,Yemen,YEM,-,-,16,48,134,104,20,100,422,10,62,136,173,24,118,523,2623
2014,Zambia,ZMB,-,-,0,0,0,0,0,57,57,0,0,0,6,0,28,34,309
2014,Zimbabwe,ZWE,-,-,72,78,61,268,14,2660,3153,67,69,43,460,10,3594,4243,22478
2014,Stateless,XXA,-,-,55,79,72,399,49,0,654,46,115,80,770,79,8,1098,27907
2014,Tibetan,TIB,-,-,0,0,0,0,0,7500,7500,0,0,0,0,0,7500,7500,15066
2014,Curacao ,CUW,-,-,0,0,0,0,0,0,0,0,0,0,0,0,0,0,35
2014,Unknown ,,-,-,236,384,281,1211,271,312,2695,252,459,296,1932,500,925,4364,101138
2015,Afghanistan,AFG,-,-,56769,184037,145658,360670,21907,3874,772915,61488,195022,159566,417862,40486,8074,882498,2666294
2015,Albania,ALB,-,-,13,28,24,209,19,1704,1997,18,23,36,224,17,1792,2110,10404
2015,Algeria,DZA,-,-,10,16,15,143,5,660,849,5,7,32,409,21,851,1325,3470
2015,Andorra,AND,-,-,0,0,0,0,0,0,0,0,0,0,0,0,0,0,5
2015,Angola,AGO,-,-,82,317,212,1059,56,1499,3225,82,239,248,1564,84,2026,4243,11855
2015,Antigua and Barbuda,ATG,-,-,0,0,0,0,0,0,0,0,0,0,0,0,0,0,56
2015,Egypt,EGY,-,-,41,83,59,226,5,225,639,41,88,53,372,20,611,1185,17929
2015,Argentina,ARG,-,-,0,0,0,10,0,5,15,0,0,0,13,0,0,13,186
2015,Armenia,ARM,-,-,12,32,44,472,136,2220,2916,18,39,48,532,95,2152,2884,11211
2015,Australia,AUS,-,-,0,0,0,0,0,0,0,0,5,0,0,0,0,5,21
2015,Azerbaijan,AZE,-,-,27,74,65,1307,480,1620,3573,18,113,75,1297,287,1507,3297,9707
2015,Bahrain,BHR,-,-,0,6,10,9,0,0,25,5,6,0,38,0,5,54,422
2015,Barbados,BRB,-,-,0,0,0,0,0,0,0,0,0,0,0,0,0,0,95
2015,Burundi,BDI,-,-,23458,28495,25803,63536,3711,355,145358,23630,26547,24706,60918,3186,376,139363,292750
2015,Belgium,BEL,-,-,0,0,5,0,0,0,5,0,0,0,0,0,0,0,66
2015,Benin,BEN,-,-,0,0,5,17,0,37,59,0,5,0,27,0,30,62,400
2015,Bangladesh,BGD,-,-,6,16,0,54,0,498,574,13,22,0,267,5,3481,3788,12154
2015,Bahamas,BHS,-,-,0,0,0,0,0,0,0,0,0,0,0,0,0,0,216
2015,Bhutan,BTN,-,-,824,1170,964,4663,565,17,8203,875,1219,1017,5119,780,102,9112,17709
2015,Burkina Faso,BFA,-,-,0,0,0,21,0,102,123,0,0,7,47,0,89,143,2147
2015,Belarus,BLR,-,-,0,5,15,83,8,277,388,5,11,22,88,16,330,472,4117
2015,Bolivia (Plurinational State of),BOL,-,-,0,18,12,45,5,17,97,0,20,0,88,7,18,133,566
2015,Botswana,BWA,-,-,0,0,0,0,0,0,0,0,0,0,0,0,0,0,306
2015,Brazil,BRA,-,-,0,7,5,19,0,11,42,0,5,10,5,0,5,25,893
2015,Bosnia and Herzegovina,BIH,-,-,24,114,247,3388,2236,2886,8895,26,129,312,3598,1319,3098,8482,18763
2015,Bulgaria,BGR,-,-,0,5,0,25,13,37,80,0,0,5,41,42,55,143,1264
2015,Belize,BLZ,-,-,0,0,0,0,0,0,0,0,0,0,0,0,0,0,48
2015,Cambodia,KHM,-,-,0,8,14,83,5,6053,6163,5,5,10,58,5,6122,6205,12802
2015,Canada,CAN,-,-,0,7,0,5,0,0,12,0,8,0,0,0,0,8,73
2015,Central African Rep.,CAF,-,-,38371,62052,37510,102508,6224,737,247402,38335,61046,35803,80904,6315,906,223309,471093
2015,Cayman Islands,CYM,-,-,0,0,0,0,0,0,0,0,0,0,0,0,0,0,6
2015,Chad,TCD,-,-,999,1363,936,2680,305,376,6659,1089,1263,887,2387,246,940,6812,14921
2015,China,CHN,-,-,38,79,60,492,40,2272,2981,27,79,45,844,83,3132,4210,212911
2015,Chile,CHL,-,-,0,0,0,69,36,60,165,0,0,0,79,75,59,213,554
2015,Cameroon,CMR,-,-,22,65,37,397,25,442,988,12,52,46,438,17,867,1432,10565
2015,Congo,COG,-,-,74,113,114,441,13,1622,2377,70,126,103,651,44,1710,2704,14772
2015,Dem. Rep. of the Congo,COD,-,-,36052,52537,36675,105500,6945,7208,244917,37278,53904,37166,100024,5855,8088,242315,541487
2015,Comoros,COM,-,-,0,0,0,0,0,187,187,0,0,0,0,0,338,338,550
2015,Colombia,COL,-,-,137,3784,10618,10058,705,3334,28636,147,3856,10543,13281,951,3806,32584,340116
2015,Costa Rica,CRI,-,-,0,5,0,0,0,0,5,0,0,0,0,0,0,0,374
2015,Cuba,CUB,-,-,0,5,39,281,48,64,437,0,5,38,612,73,118,846,6827
2015,Cabo Verde,CPV,-,-,0,0,0,0,0,0,0,0,5,0,0,0,0,5,27
2015,Czechia,CZE,-,-,0,0,9,164,178,12,363,0,0,8,236,342,29,615,1280
2015,Denmark,DNK,-,-,0,0,0,0,0,0,0,0,0,0,0,0,0,0,11
2015,Djibouti,DJI,-,-,0,5,8,18,0,215,246,0,10,7,41,0,162,220,1059
2015,Dominica,DMA,-,-,0,0,0,0,0,0,0,0,0,0,0,0,0,0,35
2015,Dominican Rep.,DOM,-,-,0,0,14,5,0,25,44,0,0,6,5,0,5,16,382
2015,Ecuador,ECU,-,-,0,22,10,25,0,13,70,0,6,9,51,0,15,81,1006
2015,Equatorial Guinea,GNQ,-,-,0,0,0,5,0,15,20,0,0,0,10,5,15,30,142
2015,Eritrea,ERI,-,-,8190,17602,13192,70120,4335,864,114303,8723,18598,17852,120127,5577,2114,172991,407428
2015,Estonia,EST,-,-,0,0,0,0,0,8,8,0,0,0,7,0,0,7,315
2015,Ethiopia,ETH,-,-,2775,3988,2343,12062,447,429,22044,3042,4116,2611,12561,496,383,23209,85839
2015,Fiji,FJI,-,-,0,0,0,0,0,0,0,0,0,0,10,0,0,10,887
2015,Finland,FIN,-,-,0,0,0,0,0,0,0,0,0,0,0,0,0,0,10
2015,France,FRA,-,-,0,0,0,0,0,0,0,0,0,0,9,5,0,14,90
2015,Gabon,GAB,-,-,0,0,0,0,0,26,26,0,0,0,5,0,26,31,174
2015,Gambia,GMB,-,-,7,11,0,74,0,136,228,0,6,7,167,0,88,268,8473
2015,Palestinian,PSE,-,-,6698,9162,5818,18050,1660,205,41593,7444,6287,10985,20447,1508,488,47159,98013
2015,United Kingdom of Great Britain and Northern Ireland,GBR,-,-,0,0,0,5,0,0,5,0,0,0,7,0,0,7,128
2015,Georgia,GEO,-,-,7,15,10,219,43,1510,1804,16,23,15,273,23,1442,1792,6505
2015,Germany,DEU,-,-,0,0,0,0,0,7,7,0,0,0,0,0,0,0,153
2015,Ghana,GHA,-,-,2183,2679,1053,4392,546,205,11058,2132,2892,1120,1611,247,351,8353,22962
2015,Guinea-Bissau,GNB,-,-,0,17,6,22,0,314,359,0,0,5,63,0,636,704,1472
2015,Greece,GRC,-,-,0,0,0,5,5,0,10,0,0,0,14,23,0,37,111
2015,Grenada,GRD,-,-,0,0,0,0,0,0,0,0,0,0,0,0,0,0,270
2015,Guatemala,GTM,-,-,0,0,0,11,0,6,17,0,5,0,11,0,23,39,10284
2015,Guinea,GIN,-,-,42,66,26,291,5,5454,5884,17,24,44,455,7,3769,4316,16995
2015,Guyana,GUY,-,-,0,0,0,0,0,5,5,0,0,0,0,0,8,8,508
2015,Haiti,HTI,-,-,13,45,59,232,24,1518,1891,5,42,51,248,34,1932,2312,34762
2015,"China, Hong Kong SAR",HKG,-,-,0,0,0,0,0,0,0,0,0,0,0,0,0,0,33
2015,Honduras,HND,-,-,0,0,22,51,0,0,73,0,5,17,62,0,0,84,6847
2015,Croatia,HRV,-,-,80,342,1078,9725,6419,49,17693,62,354,1055,10497,3511,45,15524,33452
2015,Hungary,HUN,-,-,0,0,0,28,57,41,126,0,0,0,53,165,88,306,1447
2015,Cote d'Ivoire,CIV,-,-,4155,6838,4158,14051,1000,1379,31581,4009,6778,4469,12907,645,1538,30346,71107
2015,India,IND,-,-,12,34,20,50,5,60,181,22,38,14,174,10,164,422,9882
2015,Indonesia,IDN,-,-,5,0,6,658,0,6,675,5,6,0,0,8,0,19,13947
2015,Ireland,IRL,-,-,0,0,0,0,0,0,0,0,0,0,0,0,0,0,5
2015,Iran (Islamic Rep. of),IRN,-,-,465,1196,1268,10437,1236,1859,16461,509,1306,1483,15762,1666,2671,23397,84950
2015,Iraq,IRQ,-,-,5878,10775,8297,39093,5055,2880,71978,6347,11547,9129,53717,4857,4170,89767,264086
2015,Israel,ISR,-,-,0,0,7,5,0,5,17,0,7,0,7,0,15,29,787
2015,Italy,ITA,-,-,0,0,0,6,0,0,6,0,0,0,7,0,6,13,69
2015,Jamaica,JAM,-,-,0,0,0,7,0,5,12,0,0,0,11,0,8,19,1857
2015,Jordan,JOR,-,-,6,15,7,140,5,30,203,5,11,12,72,5,49,154,1836
2015,Japan,JPN,-,-,6,26,9,5,0,0,46,13,25,12,5,0,0,55,140
2015,Kazakhstan,KAZ,-,-,0,5,8,50,29,299,391,0,5,11,55,5,256,332,2263
2015,Kenya,KEN,-,-,275,378,307,897,144,64,2065,301,403,309,655,112,43,1823,7902
2015,Kyrgyzstan,KGZ,-,-,6,27,21,87,10,185,336,13,38,28,94,0,195,368,2498
2015,Rep. of Korea,KOR,-,-,0,10,14,17,0,0,41,8,7,13,13,0,0,41,346
2015,Dem. People's Rep. of Korea,PRK,-,-,0,0,0,43,0,28,71,0,0,0,53,5,24,82,1094
2015,Kuwait,KWT,-,-,0,5,18,20,0,0,43,0,7,0,28,0,16,51,1076
2015,Lao People's Dem. Rep.,LAO,-,-,0,0,0,5,6,3383,3394,0,0,0,33,6,3710,3749,7359
2015,Liberia,LBR,-,-,260,509,457,2161,76,89,3552,238,501,513,2177,118,171,3718,9972
2015,Libya,LBY,-,-,20,33,40,149,0,152,394,20,50,36,319,10,199,634,6077
2015,Saint Lucia,LCA,-,-,0,0,0,0,0,0,0,0,0,0,0,0,0,0,1011
2015,Lebanon,LBN,-,-,8,44,22,232,44,75,425,19,38,42,596,24,158,877,4353
2015,Lesotho,LSO,-,-,0,0,0,0,0,0,0,0,0,0,0,0,0,0,16
2015,Sri Lanka,LKA,-,-,132,243,156,1451,386,40935,43303,131,245,203,4451,247,49021,54298,121427
2015,Lithuania,LTU,-,-,0,0,0,10,0,0,10,0,0,0,9,0,19,28,143
2015,Latvia,LVA,-,-,0,0,0,11,0,20,31,0,0,0,11,0,19,30,187
2015,"China, Macao SAR",MAC,-,-,0,0,0,0,0,0,0,0,0,0,0,0,0,0,5
2015,Madagascar,MDG,-,-,0,0,0,5,0,109,114,0,0,0,0,0,112,112,285
2015,Mauritania,MRT,-,-,2528,3437,1977,5433,444,1239,15058,2614,3480,1893,4948,522,4038,17495,34656
2015,North Macedonia,MKD,-,-,17,28,32,178,12,250,517,17,39,48,193,20,253,570,1769
2015,Monaco,MCO,-,-,0,0,0,0,0,0,0,0,0,0,0,0,0,0,5
2015,Rep. of Moldova,MDA,-,-,0,13,0,68,5,174,260,5,0,10,63,0,178,256,2289
2015,Maldives,MDV,-,-,0,5,0,0,0,0,5,0,0,0,0,0,0,0,39
2015,Mexico,MEX,-,-,0,0,5,23,0,6,34,0,0,11,12,0,10,33,11340
2015,Marshall Islands,MHL,-,-,0,0,0,0,0,0,0,0,0,0,0,0,0,0,5
2015,Mali,MLI,-,-,10317,20793,9643,32180,3029,3195,79157,10587,20647,9535,20799,2753,917,65238,154202
2015,Malaysia,MYS,-,-,0,6,0,0,0,12,18,0,0,0,5,0,0,5,435
2015,Malawi,MWI,-,-,9,0,0,21,0,0,30,0,5,0,8,0,0,13,429
2015,Mongolia,MNG,-,-,0,0,0,16,5,227,248,0,0,11,21,0,157,189,2198
2015,Morocco,MAR,-,-,7,14,5,94,5,101,226,5,8,23,64,6,219,325,1760
2015,Mozambique,MOZ,-,-,0,0,0,12,0,5,17,0,0,0,12,0,5,17,55
2015,Montenegro,MNE,-,-,5,8,17,104,16,51,201,5,21,17,88,5,42,178,646
2015,Mauritius,MUS,-,-,5,0,0,6,0,5,16,0,0,0,0,0,5,5,101
2015,Myanmar,MMR,-,-,10841,9906,7152,37550,2027,59,67535,11426,10468,7806,64519,2212,271,96702,451804
2015,Namibia,NAM,-,-,38,57,39,118,0,0,252,33,73,39,487,30,0,662,1272
2015,Nepal,NPL,-,-,0,0,0,16,0,36,52,0,0,5,78,0,96,179,9051
2015,Netherlands,NLD,-,-,0,0,0,6,0,0,6,0,0,0,6,0,0,6,64
2015,Niger,NER,-,-,30,45,40,98,19,61,293,33,60,28,106,7,84,318,1383
2015,Nicaragua,NIC,-,-,0,0,0,115,24,0,139,0,0,0,160,12,0,172,1469
2015,Nigeria,NGA,-,-,4868,6804,3428,10963,960,38472,65495,4914,6875,3343,8149,920,31147,55348,167973
2015,Niue,NIU,-,-,0,0,0,0,0,0,0,0,0,0,0,0,0,0,18
2015,Norway,NOR,-,-,0,0,0,0,0,0,0,0,0,0,0,0,0,0,10
2015,New Zealand,NZL,-,-,0,0,0,0,0,0,0,0,0,0,8,0,0,8,16
2015,Oman,OMN,-,-,0,0,0,0,0,0,0,0,5,0,0,0,0,5,36
2015,Pakistan,PAK,-,-,24472,20460,26484,45685,5528,243,122872,20890,20966,28025,45150,6998,937,122966,297886
2015,Panama,PAN,-,-,0,0,0,0,0,0,0,0,0,0,0,0,0,0,62
2015,Paraguay,PRY,-,-,5,0,0,8,0,0,13,0,0,0,7,0,5,12,88
2015,Peru,PER,-,-,0,0,53,476,68,143,740,0,10,51,537,80,166,844,3591
2015,Philippines,PHL,-,-,0,6,0,24,0,0,30,0,14,0,0,0,0,14,582
2015,Papua New Guinea,PNG,-,-,0,0,0,0,0,0,0,0,0,0,0,0,0,0,335
2015,Poland,POL,-,-,0,0,14,106,107,136,363,0,7,0,238,286,180,711,1298
2015,Portugal,PRT,-,-,0,0,0,0,0,5,5,0,0,0,0,5,0,5,28
2015,Qatar,QAT,-,-,0,0,0,0,0,0,0,0,0,0,0,0,0,0,21
2015,Romania,ROU,-,-,0,0,11,146,47,83,287,0,7,11,232,105,114,469,1731
2015,South Africa,ZAF,-,-,0,9,5,31,0,9,54,0,5,7,28,8,26,74,447
2015,Russian Federation,RUS,-,-,160,474,406,1987,247,8767,12041,160,504,477,1899,149,8329,11518,67008
2015,Rwanda,RWA,-,-,28811,36259,24794,47303,2525,1944,141636,25384,36966,26074,45949,3212,1779,139364,286357
2015,El Salvador,SLV,-,-,8,25,18,198,45,12,306,14,14,40,235,57,12,372,14778
2015,Saudi Arabia,SAU,-,-,5,6,5,19,0,5,40,0,0,0,9,0,0,9,686
2015,Serbia and Kosovo: S/RES/1244 (1999),SRB,-,-,107,353,488,4025,853,6101,11927,133,361,584,4132,835,6766,12811,38620
2015,Senegal,SEN,-,-,441,808,556,1820,225,645,4495,399,843,558,1655,278,583,4316,21267
2015,Seychelles,SYC,-,-,0,0,0,0,0,0,0,0,0,0,0,0,0,0,19
2015,Singapore,SGP,-,-,0,0,0,0,0,0,0,0,0,6,0,0,0,6,50
2015,Sierra Leone,SLE,-,-,45,67,93,387,10,202,804,23,77,95,680,20,320,1215,4900
2015,Solomon Islands,SLB,-,-,0,0,0,0,0,0,0,0,0,0,0,0,0,0,71
2015,Somalia,SOM,-,-,57963,111846,71365,222138,13588,3489,480389,60626,115340,77813,244980,12864,4263,515886,1123144
2015,Spain,ESP,-,-,0,10,0,5,0,0,15,0,0,0,0,9,0,9,60
2015,Viet Nam,VNM,-,-,13,35,40,378,144,3625,4235,23,43,28,783,178,4554,5609,313152
2015,Saint Kitts and Nevis,KNA,-,-,0,0,0,0,0,0,0,0,0,0,0,0,0,0,25
2015,Sao Tome and Principe,STP,-,-,0,0,5,6,0,0,11,8,0,0,0,0,5,13,24
2015,Sudan,SDN,-,-,51242,76800,47146,135116,11605,564,322473,53229,77147,46296,95658,9002,3772,285104,627080
2015,Suriname,SUR,-,-,0,0,0,0,0,0,0,0,0,0,0,0,0,0,19
2015,South Sudan,SSD,-,-,60256,90313,55799,130467,9724,17605,364164,61708,94767,62865,80071,4159,13837,317407,778722
2015,Slovakia,SVK,-,-,0,0,0,25,18,57,100,0,0,0,41,34,57,132,325
2015,Slovenia,SVN,-,-,0,0,0,0,0,0,0,0,0,0,0,7,0,7,21
2015,Eswatini,SWZ,-,-,0,0,0,0,0,0,0,0,0,0,11,0,0,11,213
2015,Sweden,SWE,-,-,0,0,0,5,0,0,5,0,0,0,0,0,0,0,18
2015,Switzerland,CHE,-,-,0,0,0,0,0,0,0,0,0,0,0,0,0,0,16
2015,Syrian Arab Rep.,SYR,-,-,171915,221271,129786,516772,36396,4155,1080295,179978,234135,139606,532286,28900,6446,1121351,4873236
2015,United Rep. of Tanzania,TZA,-,-,7,20,10,23,0,45,105,11,16,0,43,0,22,92,810
2015,Turks and Caicos Islands,TCA,-,-,0,0,0,0,0,0,0,0,0,0,0,0,0,0,14
2015,Thailand,THA,-,-,0,0,15,26,0,0,41,0,5,8,8,0,5,26,209
2015,Tajikistan,TJK,-,-,0,9,12,35,5,32,93,0,23,18,55,5,35,136,790
2015,Turkmenistan,TKM,-,-,5,5,0,9,0,18,37,0,0,5,15,0,21,41,446
2015,Timor-Leste,TLS,-,-,0,0,0,0,0,0,0,0,0,0,0,0,0,0,19
2015,Togo,TGO,-,-,197,325,258,996,75,288,2139,224,391,188,1791,111,589,3294,8774
2015,Tonga,TON,-,-,0,0,0,0,0,0,0,0,0,0,0,0,0,0,22
2015,Trinidad and Tobago,TTO,-,-,0,0,0,0,0,0,0,0,0,0,0,0,0,0,369
2015,Tunisia,TUN,-,-,5,14,22,44,0,81,166,15,16,19,79,5,196,330,1554
2015,Türkiye,TUR,-,-,310,1433,1895,10786,2307,3196,19927,346,1493,2054,13852,1941,8104,27790,59545
2015,United Arab Emirates,ARE,-,-,0,0,0,0,0,0,0,0,0,0,0,0,0,0,91
2015,Uganda,UGA,-,-,35,85,67,281,5,80,553,44,78,66,397,29,82,696,6311
2015,Ukraine,UKR,-,-,45,87,58,460,75,644,1369,44,74,67,354,33,522,1094,321399
2015,Uruguay,URY,-,-,0,0,0,0,0,0,0,0,0,0,0,0,0,0,84
2015,United States of America,USA,-,-,7,34,28,15,5,0,89,9,19,22,21,10,0,81,4824
2015,Uzbekistan,UZB,-,-,10,19,15,79,6,156,285,10,17,40,79,5,141,292,4197
2015,Saint Vincent and the Grenadines,VCT,-,-,0,0,0,0,0,0,0,0,0,0,0,0,0,0,1823
2015,Venezuela (Bolivarian Republic of),VEN,-,-,0,10,17,26,0,21,74,5,5,5,39,0,17,71,7455
2015,Western Sahara,ESH,-,-,0,0,0,17,0,38,55,0,0,0,169,0,266,435,116542
2015,Yemen,YEM,-,-,701,1074,859,3092,303,27,6056,671,1151,926,4487,267,63,7565,15901
2015,Zambia,ZMB,-,-,0,5,0,0,0,0,5,0,0,0,6,0,0,6,334
2015,Zimbabwe,ZWE,-,-,54,72,54,281,8,13,482,68,69,50,356,11,21,575,21332
2015,Stateless,XXA,-,-,89,156,110,615,64,26,1060,89,175,124,1519,126,48,2081,37415
2015,Tibetan,TIB,-,-,0,0,0,7500,0,0,7500,0,0,0,7500,0,0,7500,15069
2015,Curacao ,CUW,-,-,0,0,0,0,0,0,0,0,0,0,0,0,0,0,35
2015,Unknown ,,-,-,298,583,409,2214,322,7087,10913,367,709,587,4791,569,9237,16260,120122
2016,Afghanistan,AFG,-,-,79220,143429,115084,304844,27594,3236,673407,84581,153150,126023,372771,44348,10407,791280,2501447
2016,Albania,ALB,-,-,27,38,52,299,21,2094,2531,27,42,60,304,22,2116,2571,11060
2016,Algeria,DZA,-,-,11,15,24,178,7,723,958,15,20,28,454,22,933,1472,3705
2016,Angola,AGO,-,-,91,292,219,983,60,1524,3169,73,214,223,1522,107,2051,4190,8388
2016,Antigua and Barbuda,ATG,-,-,0,0,0,8,0,0,8,0,0,0,0,0,0,0,82
2016,Egypt,EGY,-,-,65,106,116,353,26,278,944,60,130,101,597,43,710,1641,19792
2016,Argentina,ARG,-,-,0,0,0,11,0,5,16,0,0,0,13,0,0,13,120
2016,Armenia,ARM,-,-,14,38,46,502,159,2257,3016,20,55,59,551,120,2200,3005,10707
2016,Australia,AUS,-,-,0,0,0,0,0,0,0,0,5,0,0,0,0,5,15
2016,Azerbaijan,AZE,-,-,37,87,67,1209,401,1646,3447,29,128,78,1197,248,1591,3271,10118
2016,Bahrain,BHR,-,-,5,13,10,9,0,0,37,0,6,5,39,0,5,55,461
2016,Barbados,BRB,-,-,0,0,0,11,0,0,11,0,0,0,13,0,0,13,144
2016,Burundi,BDI,-,-,36709,40967,29656,83542,4808,1676,197358,37364,41980,31529,90204,3989,2580,207646,408066
2016,Belgium,BEL,-,-,0,0,5,0,0,0,5,0,0,0,0,0,0,0,44
2016,Benin,BEN,-,-,0,0,5,32,0,33,70,0,5,0,36,0,38,79,479
2016,Bangladesh,BGD,-,-,15,17,0,101,0,644,777,22,17,13,388,13,4335,4788,13842
2016,Bahamas,BHS,-,-,0,0,0,13,0,0,13,0,0,0,21,0,0,21,298
2016,Bhutan,BTN,-,-,476,793,676,2935,444,17,5341,509,853,651,3327,611,99,6050,11757
2016,Burkina Faso,BFA,-,-,0,10,0,17,0,123,150,0,5,0,46,0,96,147,2352
2016,Belarus,BLR,-,-,5,5,6,92,8,276,392,5,7,16,82,12,339,461,3831
2016,Bolivia (Plurinational State of),BOL,-,-,8,18,12,36,5,17,96,0,20,0,80,8,19,127,530
2016,Botswana,BWA,-,-,0,6,0,0,0,0,6,0,0,0,6,0,0,6,265
2016,Brazil,BRA,-,-,0,5,5,18,0,7,35,0,0,5,10,0,5,20,803
2016,Bosnia and Herzegovina,BIH,-,-,19,128,239,3326,2165,2837,8714,23,124,297,3487,1311,2955,8197,18194
2016,Bulgaria,BGR,-,-,0,5,0,12,13,34,64,0,5,0,19,41,53,118,799
2016,Belize,BLZ,-,-,0,0,0,0,0,0,0,0,0,0,0,0,0,0,58
2016,Cambodia,KHM,-,-,5,9,6,65,0,5890,5975,12,6,5,82,10,6012,6127,12428
2016,Canada,CAN,-,-,0,8,0,5,0,0,13,0,5,0,5,0,0,10,76
2016,Central African Rep.,CAF,-,-,37518,62446,37226,113799,7334,1110,259433,37600,61689,36812,86364,7341,1248,231054,490879
2016,Cayman Islands,CYM,-,-,0,0,0,0,0,0,0,0,0,0,0,0,0,0,6
2016,Chad,TCD,-,-,1011,1279,864,2572,274,412,6412,1108,1203,777,2139,219,985,6431,14176
2016,China,CHN,-,-,134,166,104,1431,67,2445,4347,158,137,110,2116,97,3606,6224,207768
2016,Chile,CHL,-,-,0,0,5,63,36,63,167,0,0,0,66,76,63,205,495
2016,Cameroon,CMR,-,-,22,48,34,439,25,622,1190,14,58,45,504,16,1179,1816,10344
2016,Congo,COG,-,-,56,120,151,371,19,4080,4797,67,149,162,493,39,4663,5573,13291
2016,Dem. Rep. of the Congo,COD,-,-,36760,55235,36120,106671,7235,19644,261665,37294,55589,36429,97721,5972,23366,256371,537474
2016,Comoros,COM,-,-,0,0,0,0,0,197,197,0,0,0,0,0,355,355,572
2016,Colombia,COL,-,-,51,182,391,1005,121,4811,6561,35,176,344,1813,152,5631,8151,311059
2016,Costa Rica,CRI,-,-,0,0,5,0,0,0,5,0,0,0,0,0,0,0,202
2016,Cuba,CUB,-,-,0,0,25,239,37,228,529,0,11,28,514,41,348,942,5940
2016,Cabo Verde,CPV,-,-,0,0,0,0,0,0,0,0,5,0,0,0,0,5,10
2016,Czechia,CZE,-,-,0,5,0,124,180,19,328,0,0,0,176,346,22,544,1266
2016,Djibouti,DJI,-,-,0,5,14,48,0,270,337,5,19,17,78,0,203,322,1437
2016,Dominica,DMA,-,-,0,0,0,0,0,0,0,0,0,0,0,0,0,0,20
2016,Dominican Rep.,DOM,-,-,0,0,12,16,0,32,60,0,0,5,9,0,9,23,359
2016,Ecuador,ECU,-,-,0,22,18,25,0,13,78,0,12,0,46,0,14,72,1041
2016,Equatorial Guinea,GNQ,-,-,0,0,0,6,0,15,21,0,0,0,10,5,14,29,131
2016,Eritrea,ERI,-,-,8594,18604,14743,61214,4458,9800,117413,8922,19700,18379,75419,5599,14717,142736,457247
2016,Estonia,EST,-,-,0,0,0,0,0,8,8,0,0,0,0,0,0,0,303
2016,Ethiopia,ETH,-,-,2747,4048,2730,12129,445,5068,27167,2926,4251,2929,11997,535,14217,36855,83958
2016,Fiji,FJI,-,-,0,0,0,0,0,0,0,0,0,0,0,0,0,0,791
2016,Finland,FIN,-,-,0,0,0,0,0,0,0,0,0,0,0,0,0,0,5
2016,France,FRA,-,-,0,0,0,0,0,0,0,0,0,0,9,5,0,14,50
2016,Gabon,GAB,-,-,0,0,0,5,0,33,38,0,0,0,10,0,35,45,167
2016,Gambia,GMB,-,-,8,16,5,92,0,143,264,10,6,0,253,0,112,381,11589
2016,Palestinian,PSE,-,-,6707,9044,5813,17717,1619,305,41205,7446,5694,10882,20028,1450,1076,46576,97794
2016,United Kingdom of Great Britain and Northern Ireland,GBR,-,-,0,0,0,5,0,0,5,0,0,0,8,0,0,8,78
2016,Georgia,GEO,-,-,5,25,24,240,43,1603,1940,10,32,26,273,23,1524,1888,6405
2016,Germany,DEU,-,-,0,0,0,0,0,7,7,0,0,0,0,0,0,0,67
2016,Ghana,GHA,-,-,1168,1393,554,2368,291,205,5979,1112,1506,587,970,145,354,4674,15527
2016,Guinea-Bissau,GNB,-,-,0,21,5,26,0,299,351,0,5,0,69,0,623,697,1650
2016,Greece,GRC,-,-,0,0,0,0,7,0,7,0,0,0,12,26,0,38,101
2016,Grenada,GRD,-,-,0,0,0,7,0,0,7,0,0,0,0,0,0,0,100
2016,Guatemala,GTM,-,-,0,0,0,20,0,16,36,0,0,10,16,0,32,58,12549
2016,Guinea,GIN,-,-,53,69,38,337,5,5711,6213,35,30,41,538,7,3866,4517,17536
2016,Guyana,GUY,-,-,0,0,0,0,0,5,5,0,0,0,0,0,11,11,269
2016,Haiti,HTI,-,-,0,46,68,334,34,1541,2023,7,46,60,345,48,1920,2426,29671
2016,"China, Hong Kong SAR",HKG,-,-,0,0,0,0,0,0,0,0,0,0,0,0,0,0,15
2016,Honduras,HND,-,-,5,0,34,61,0,40,140,0,12,20,98,0,52,182,10509
2016,Croatia,HRV,-,-,0,137,739,7800,5528,52,14256,0,130,682,8037,2830,39,11718,26231
2016,Hungary,HUN,-,-,6,0,0,74,68,31,179,7,0,5,171,142,91,416,2909
2016,Cote d'Ivoire,CIV,-,-,2192,3783,2412,8323,506,1583,18799,2203,3796,2416,8458,409,1599,18881,46811
2016,India,IND,-,-,5,27,17,104,0,62,215,9,24,23,237,13,174,480,7288
2016,Indonesia,IDN,-,-,57,18,16,228,5,5,329,70,22,20,192,14,0,318,13056
2016,Iran (Islamic Rep. of),IRN,-,-,611,1349,1306,11878,1324,1775,18243,640,1039,1542,17473,1860,3392,25946,94102
2016,Iraq,IRQ,-,-,7448,13802,9591,48930,5853,4798,90422,8199,14892,11636,66614,5569,7499,114409,316056
2016,Israel,ISR,-,-,0,0,5,6,0,10,21,0,0,10,16,0,13,39,487
2016,Italy,ITA,-,-,0,0,0,6,0,6,12,0,0,0,8,0,0,8,49
2016,Jamaica,JAM,-,-,0,7,0,38,0,5,50,0,5,0,38,0,9,52,1998
2016,Jordan,JOR,-,-,5,16,9,195,5,41,271,7,14,22,93,6,47,189,1919
2016,Japan,JPN,-,-,0,11,5,5,0,0,21,0,6,5,5,0,0,16,53
2016,Kazakhstan,KAZ,-,-,0,10,6,53,38,317,424,0,10,10,60,5,262,347,2366
2016,Kenya,KEN,-,-,300,363,311,905,152,156,2187,334,398,304,660,113,137,1946,7526
2016,Kyrgyzstan,KGZ,-,-,10,32,15,102,11,187,357,6,47,25,103,0,201,382,2571
2016,Rep. of Korea,KOR,-,-,0,6,6,20,0,0,32,5,0,10,15,0,0,30,243
2016,Dem. People's Rep. of Korea,PRK,-,-,0,0,0,36,5,25,66,0,0,0,54,5,23,82,1419
2016,Kuwait,KWT,-,-,0,0,18,21,0,0,39,0,0,8,36,0,48,92,1013
2016,Lao People's Dem. Rep.,LAO,-,-,0,0,0,0,9,3301,3310,0,0,0,33,6,3686,3725,7229
2016,Liberia,LBR,-,-,131,193,267,1207,54,106,1958,122,213,258,1363,37,220,2213,6558
2016,Libya,LBY,-,-,44,76,54,275,0,187,636,47,89,56,636,11,375,1214,8831
2016,Saint Lucia,LCA,-,-,0,0,9,0,0,0,9,0,0,6,11,0,0,17,993
2016,Lebanon,LBN,-,-,20,59,39,356,53,82,609,40,54,45,723,26,173,1061,4719
2016,Lesotho,LSO,-,-,0,0,0,0,0,0,0,0,0,0,0,0,0,0,5
2016,Sri Lanka,LKA,-,-,306,214,160,1485,357,41140,43662,303,237,223,3832,256,50664,55515,117472
2016,Lithuania,LTU,-,-,0,0,0,5,0,0,5,0,0,0,0,0,19,19,74
2016,Latvia,LVA,-,-,0,0,0,0,0,19,19,0,0,0,14,0,19,33,165
2016,"China, Macao SAR",MAC,-,-,0,0,0,0,0,0,0,0,0,0,0,0,0,0,5
2016,Madagascar,MDG,-,-,0,0,0,5,0,111,116,0,0,0,5,0,114,119,292
2016,Mauritania,MRT,-,-,2668,3691,2093,5730,464,1265,15911,2761,3743,2048,5291,569,4124,18536,36263
2016,North Macedonia,MKD,-,-,18,39,48,234,15,218,572,20,47,47,194,24,246,578,1730
2016,Monaco,MCO,-,-,0,0,0,0,0,0,0,0,0,0,0,0,0,0,5
2016,Rep. of Moldova,MDA,-,-,9,5,0,67,5,172,258,5,0,5,61,0,182,253,2316
2016,Maldives,MDV,-,-,0,5,0,0,0,0,5,0,0,0,8,0,0,8,58
2016,Mexico,MEX,-,-,0,0,11,30,0,8,49,0,0,11,37,0,24,72,10387
2016,Marshall Islands,MHL,-,-,0,0,0,0,0,0,0,0,0,0,0,0,0,0,5
2016,Mali,MLI,-,-,9810,15478,18593,27733,2932,3366,77912,10006,15196,13348,23466,2783,923,65722,156415
2016,Malaysia,MYS,-,-,0,0,7,0,0,7,14,0,0,0,5,0,0,5,453
2016,Malawi,MWI,-,-,5,10,0,21,0,0,36,0,5,0,12,0,0,17,427
2016,Mongolia,MNG,-,-,9,0,0,71,10,249,339,7,18,12,42,0,165,244,2282
2016,Morocco,MAR,-,-,27,14,13,181,7,129,371,12,14,13,111,7,317,474,2240
2016,Mozambique,MOZ,-,-,0,0,0,12,0,0,12,0,0,0,12,0,9,21,48
2016,Montenegro,MNE,-,-,5,5,20,115,15,57,217,6,15,21,98,7,53,200,713
2016,Mauritius,MUS,-,-,5,0,0,6,0,5,16,0,0,0,0,0,5,5,106
2016,Myanmar,MMR,-,-,8681,9112,6412,36072,1852,56,62185,9091,9474,7195,69205,2006,293,97264,490285
2016,Namibia,NAM,-,-,33,69,39,126,0,0,267,28,71,46,505,30,0,680,1363
2016,Nepal,NPL,-,-,0,0,7,30,12,43,92,0,0,17,127,0,106,250,8364
2016,Netherlands,NLD,-,-,0,0,0,9,0,0,9,0,0,0,5,0,0,5,32
2016,Niger,NER,-,-,40,47,45,111,19,50,312,46,56,24,121,7,94,348,1230
2016,Nicaragua,NIC,-,-,0,0,6,112,24,183,325,0,0,0,147,12,275,434,1409
2016,Nigeria,NGA,-,-,18489,23321,10154,35485,2755,1078,91282,19594,24327,10823,28254,4374,653,88025,229290
2016,Niue,NIU,-,-,0,0,0,0,0,0,0,0,0,0,0,0,0,0,19
2016,Norway,NOR,-,-,0,0,0,0,0,0,0,0,0,0,0,0,0,0,10
2016,New Zealand,NZL,-,-,0,0,0,0,0,0,0,0,0,0,8,0,0,8,25
2016,Oman,OMN,-,-,0,0,0,0,0,0,0,0,0,5,0,0,0,5,35
2016,Pakistan,PAK,-,-,5848,12039,2383,9292,837,287,30686,6075,13653,4781,14308,1325,1150,41292,105419
2016,Panama,PAN,-,-,0,0,0,0,0,0,0,0,0,0,0,0,0,0,33
2016,Paraguay,PRY,-,-,5,0,0,8,0,6,19,0,0,0,8,0,0,8,68
2016,Peru,PER,-,-,0,0,5,262,60,135,462,0,0,13,274,63,181,531,2599
2016,Philippines,PHL,-,-,0,0,6,34,0,0,40,0,5,7,0,0,0,12,426
2016,Papua New Guinea,PNG,-,-,0,0,0,0,0,0,0,0,0,0,0,0,0,0,401
2016,Poland,POL,-,-,0,0,7,78,109,123,317,0,0,6,180,317,179,682,1159
2016,Portugal,PRT,-,-,0,0,0,0,0,5,5,0,0,0,0,5,0,5,20
2016,Qatar,QAT,-,-,0,0,0,0,0,0,0,0,0,0,0,0,0,0,25
2016,Romania,ROU,-,-,0,0,6,41,34,88,169,0,5,7,56,85,122,275,1195
2016,South Africa,ZAF,-,-,0,5,11,36,0,9,61,0,6,0,26,8,26,66,452
2016,Russian Federation,RUS,-,-,166,510,438,2111,270,9477,12972,150,527,468,1956,169,8884,12154,62759
2016,Rwanda,RWA,-,-,28822,36226,24943,47441,2524,2588,142544,25362,37089,26286,46168,3243,2557,140705,286063
2016,El Salvador,SLV,-,-,8,29,28,247,45,220,577,9,18,63,285,57,317,749,19617
2016,Saudi Arabia,SAU,-,-,10,13,0,54,0,13,90,6,14,0,39,0,5,64,937
2016,Serbia and Kosovo: S/RES/1244 (1999),SRB,-,-,136,402,517,4628,948,6791,13422,162,398,623,4609,901,7487,14180,36928
2016,Senegal,SEN,-,-,1030,1814,1107,3959,543,737,9190,990,1882,1139,3117,520,651,8299,23054
2016,Seychelles,SYC,-,-,0,0,0,0,0,0,0,0,0,0,0,0,0,0,10
2016,Singapore,SGP,-,-,0,0,0,0,0,0,0,0,5,0,0,0,0,5,38
2016,Sierra Leone,SLE,-,-,38,63,78,400,5,222,806,11,61,80,702,20,354,1228,4678
2016,Solomon Islands,SLB,-,-,0,0,0,0,0,0,0,0,5,0,0,0,0,5,71
2016,Somalia,SOM,-,-,47547,98114,65521,206310,12550,7543,437585,49298,101446,69913,230027,12200,26366,489250,1012320
2016,Spain,ESP,-,-,0,5,0,0,0,0,5,0,0,0,0,8,5,13,34
2016,Viet Nam,VNM,-,-,18,31,38,380,156,4039,4662,28,43,27,766,181,5080,6125,329341
2016,Saint Kitts and Nevis,KNA,-,-,0,0,0,0,0,0,0,0,0,0,0,0,0,0,49
2016,Sao Tome and Principe,STP,-,-,0,5,0,10,0,0,15,0,5,0,6,0,5,16,31
2016,Sudan,SDN,-,-,56994,78279,49280,137279,11789,822,334443,58884,78755,47571,94238,9223,6707,295378,650391
2016,Suriname,SUR,-,-,0,0,0,0,0,0,0,0,0,0,0,0,0,0,16
2016,South Sudan,SSD,-,-,95451,140055,86044,196815,15629,151308,685302,97088,145646,96047,116978,6001,86072,547832,1436707
2016,Slovakia,SVK,-,-,0,0,0,18,17,59,94,0,0,0,66,34,56,156,792
2016,Slovenia,SVN,-,-,0,0,0,0,0,0,0,0,0,0,0,7,0,7,20
2016,Eswatini,SWZ,-,-,0,0,0,11,0,0,11,0,0,0,9,0,0,9,224
2016,Sweden,SWE,-,-,0,0,0,5,0,0,5,0,0,0,0,0,0,0,13
2016,Switzerland,CHE,-,-,0,0,0,0,0,0,0,0,0,0,0,0,0,0,5
2016,Syrian Arab Rep.,SYR,-,-,159032,221134,128336,501263,35529,9297,1054591,167715,235342,141829,556236,28623,15042,1144787,5524511
2016,United Rep. of Tanzania,TZA,-,-,0,0,5,21,0,54,80,0,0,0,42,0,37,79,579
2016,Turks and Caicos Islands,TCA,-,-,0,0,0,0,0,0,0,0,0,0,0,0,0,0,14
2016,Thailand,THA,-,-,0,0,5,16,0,0,21,0,5,5,10,5,6,31,147
2016,Tajikistan,TJK,-,-,6,13,10,50,6,35,120,5,20,16,79,5,37,162,932
2016,Turkmenistan,TKM,-,-,0,10,0,17,0,17,44,0,0,0,17,0,20,37,371
2016,Timor-Leste,TLS,-,-,0,0,0,0,0,0,0,0,0,0,0,0,0,0,19
2016,Togo,TGO,-,-,122,319,278,1183,82,584,2568,126,350,244,1960,119,915,3714,8296
2016,Tonga,TON,-,-,0,0,0,0,0,0,0,0,0,0,0,0,0,0,25
2016,Trinidad and Tobago,TTO,-,-,0,0,0,0,0,0,0,0,0,0,0,0,0,0,295
2016,Tunisia,TUN,-,-,6,6,0,61,0,194,267,9,0,18,71,5,383,486,1687
2016,Türkiye,TUR,-,-,333,1222,1692,10691,2399,4212,20549,391,304,1901,13744,2093,10944,29377,57915
2016,United Arab Emirates,ARE,-,-,0,5,0,0,0,0,5,5,0,0,0,0,0,5,103
2016,Uganda,UGA,-,-,33,92,59,329,18,225,756,48,91,55,420,32,482,1128,6229
2016,Ukraine,UKR,-,-,43,100,58,554,85,862,1702,31,70,81,401,45,711,1339,239062
2016,Uruguay,URY,-,-,0,0,0,0,0,0,0,0,0,0,0,0,0,0,23
2016,United States of America,USA,-,-,10,26,36,23,6,0,101,10,28,24,28,10,0,100,302
2016,Uzbekistan,UZB,-,-,0,11,22,83,12,185,313,19,16,28,86,5,172,326,3824
2016,Saint Vincent and the Grenadines,VCT,-,-,0,7,15,14,0,0,36,0,6,6,14,0,0,26,1335
2016,Venezuela (Bolivarian Republic of),VEN,-,-,0,15,24,89,0,137,265,10,5,5,117,5,186,328,7543
2016,Western Sahara,ESH,-,-,0,0,0,23,0,44119,44142,0,0,0,146,0,46309,46455,116648
2016,Yemen,YEM,-,-,610,1240,955,3578,306,154,6843,630,1339,1041,5249,353,222,8834,18427
2016,Zambia,ZMB,-,-,0,0,0,5,0,47,52,0,0,0,5,0,20,25,256
2016,Zimbabwe,ZWE,-,-,54,94,48,331,8,2024,2559,69,70,54,381,17,2615,3206,18141
2016,Stateless,XXA,-,-,197,351,227,1403,87,160,2425,206,420,357,3395,159,342,4879,48687
2016,Tibetan,TIB,-,-,0,0,0,7003,0,0,7003,0,0,0,6511,0,0,6511,13536
2016,Curacao ,CUW,-,-,0,0,0,0,0,0,0,0,0,0,0,0,0,0,35
2016,Unknown ,,-,-,925,1325,825,4645,457,3552,11729,921,1559,1150,10442,778,5161,20011,138787
2017,Afghanistan,AFG,-,-,101802,150698,113131,321327,27949,2913,717820,107348,161457,126045,400140,44611,16021,855622,2624265
2017,Albania,ALB,-,-,37,67,59,400,26,2247,2836,39,62,83,339,27,2134,2684,12168
2017,Algeria,DZA,-,-,26,24,28,242,8,782,1110,29,41,24,441,28,947,1510,4021
2017,Angola,AGO,-,-,89,192,162,805,60,1522,2830,78,190,194,773,116,1992,3343,8292
2017,Antigua and Barbuda,ATG,-,-,0,0,0,0,0,0,0,0,0,0,0,0,0,0,99
2017,Egypt,EGY,-,-,108,166,132,519,16,274,1215,109,180,133,850,39,714,2025,22106
2017,Argentina,ARG,-,-,0,0,0,6,0,5,11,0,0,0,0,8,0,8,121
2017,Armenia,ARM,-,-,48,78,84,725,204,2198,3337,68,108,87,724,145,2119,3251,10786
2017,Australia,AUS,-,-,0,0,0,0,0,0,0,0,0,5,0,0,0,5,10
2017,Austria,AUT,-,-,0,5,0,0,0,0,5,0,0,0,0,0,0,0,10
2017,Azerbaijan,AZE,-,-,104,174,115,1452,428,1596,3869,126,204,155,1419,252,1531,3687,10893
2017,Bahrain,BHR,-,-,0,15,17,12,0,0,44,5,5,5,46,0,6,67,497
2017,Barbados,BRB,-,-,0,0,0,0,0,0,0,0,0,0,0,0,0,0,172
2017,Burundi,BDI,-,-,39247,46588,28145,95942,5685,2005,217612,38712,45387,28240,98183,4591,2644,217757,439320
2017,Belgium,BEL,-,-,0,0,0,6,0,0,6,0,0,0,0,0,0,0,52
2017,Benin,BEN,-,-,8,0,0,38,0,26,72,6,0,5,40,0,18,69,572
2017,Bangladesh,BGD,-,-,29,26,5,104,5,778,947,16,23,20,566,13,4727,5365,16780
2017,Bahamas,BHS,-,-,0,0,0,0,0,0,0,0,0,0,0,0,0,0,378
2017,Bhutan,BTN,-,-,266,497,415,1898,345,18,3439,312,547,415,2280,478,99,4131,7954
2017,Burkina Faso,BFA,-,-,7,0,0,30,0,113,150,6,0,5,38,0,85,134,2694
2017,Belarus,BLR,-,-,5,15,5,98,7,262,392,7,17,14,83,13,296,430,3650
2017,Bolivia (Plurinational State of),BOL,-,-,0,0,12,13,0,17,42,0,0,0,14,8,19,41,520
2017,Botswana,BWA,-,-,0,0,0,5,0,0,5,0,0,0,0,0,0,0,279
2017,Brazil,BRA,-,-,0,5,6,18,0,7,36,0,0,17,5,0,5,27,851
2017,Bosnia and Herzegovina,BIH,-,-,23,114,237,3207,2095,2747,8423,20,127,281,3363,1278,2929,7998,17690
2017,Bulgaria,BGR,-,-,0,0,6,15,13,27,61,0,5,0,14,38,44,101,716
2017,Belize,BLZ,-,-,0,0,0,0,0,0,0,0,0,0,0,0,0,0,64
2017,Cambodia,KHM,-,-,8,10,14,95,5,5823,5955,7,13,11,65,10,5860,5966,12238
2017,Canada,CAN,-,-,0,8,0,5,0,0,13,0,0,6,5,0,0,11,75
2017,Central African Rep.,CAF,-,-,52551,65429,47119,112963,8164,1269,287495,52811,64846,42138,88803,7525,1387,257510,545513
2017,Cayman Islands,CYM,-,-,0,0,0,0,0,0,0,0,0,0,0,0,0,0,6
2017,Chad,TCD,-,-,1155,1595,998,2912,282,425,7367,1187,1509,912,2564,263,1198,7633,16325
2017,China,CHN,-,-,128,114,78,1324,76,2376,4096,153,122,72,1881,112,3029,5369,207716
2017,Chile,CHL,-,-,0,0,0,62,38,46,146,0,0,0,41,75,33,149,493
2017,Cameroon,CMR,-,-,27,36,36,382,31,540,1052,29,31,62,500,19,971,1612,11032
2017,Congo,COG,-,-,69,85,104,416,13,4028,4715,66,154,85,539,46,4615,5505,13295
2017,Dem. Rep. of the Congo,COD,-,-,43781,60190,42197,119627,7352,23206,296353,43693,60861,43629,114102,6487,37887,306659,620805
2017,Comoros,COM,-,-,0,0,0,0,0,207,207,0,0,0,0,0,368,368,600
2017,Colombia,COL,-,-,78,588,1447,9588,840,2924,15465,73,615,1506,10864,1116,3569,17743,191635
2017,Costa Rica,CRI,-,-,0,0,5,0,0,0,5,0,0,0,0,0,0,0,195
2017,Cuba,CUB,-,-,5,5,36,311,47,222,626,9,17,19,562,61,344,1012,5331
2017,Cabo Verde,CPV,-,-,0,0,0,0,0,0,0,0,0,0,0,0,0,0,5
2017,Czechia,CZE,-,-,0,0,0,93,195,11,299,0,0,0,143,346,23,512,1272
2017,Djibouti,DJI,-,-,5,5,8,30,0,169,217,0,14,8,40,0,101,163,1761
2017,Dominica,DMA,-,-,0,0,0,0,0,0,0,0,0,0,0,0,0,0,26
2017,Dominican Rep.,DOM,-,-,0,0,5,14,0,39,58,0,0,0,0,0,10,10,427
2017,Ecuador,ECU,-,-,0,13,19,14,0,12,58,0,6,0,5,0,14,25,1251
2017,Equatorial Guinea,GNQ,-,-,0,0,0,10,0,17,27,0,0,0,12,5,15,32,127
2017,Eritrea,ERI,-,-,12237,20568,25740,75326,4834,14254,152959,12515,21339,27994,135791,6011,13086,216736,486209
2017,Estonia,EST,-,-,0,0,0,0,0,7,7,0,0,5,0,0,0,5,288
2017,Ethiopia,ETH,-,-,2876,4033,2991,13003,505,5172,28580,3002,4282,3353,12894,555,14127,38213,87448
2017,Fiji,FJI,-,-,0,0,0,0,0,0,0,0,0,0,0,0,0,0,734
2017,Finland,FIN,-,-,0,0,0,0,0,0,0,0,0,0,0,0,0,0,5
2017,France,FRA,-,-,0,0,0,0,0,0,0,0,0,0,9,6,0,15,54
2017,Gabon,GAB,-,-,0,0,0,0,0,41,41,0,0,0,8,0,41,49,216
2017,Gambia,GMB,-,-,20,18,16,152,0,173,379,22,26,20,374,0,100,542,14564
2017,Palestinian,PSE,-,-,6653,8979,5830,17776,1694,326,41258,7338,6146,10912,19780,1580,562,46318,99630
2017,United Kingdom of Great Britain and Northern Ireland,GBR,-,-,0,0,0,6,0,0,6,6,0,0,6,0,0,12,85
2017,Georgia,GEO,-,-,14,32,23,261,51,1617,1998,19,43,39,272,27,1529,1929,6535
2017,Germany,DEU,-,-,0,0,0,0,0,6,6,0,0,0,0,0,0,0,66
2017,Ghana,GHA,-,-,1204,1404,554,2402,295,205,6064,1146,1513,587,993,156,316,4711,16959
2017,Guinea-Bissau,GNB,-,-,6,6,12,32,0,304,360,7,0,8,81,0,600,696,1870
2017,Greece,GRC,-,-,0,0,0,6,0,0,6,0,0,0,13,29,0,42,106
2017,Grenada,GRD,-,-,0,0,0,0,0,0,0,0,0,0,0,0,0,0,103
2017,Guatemala,GTM,-,-,0,0,0,11,0,16,27,0,0,6,16,0,24,46,16284
2017,Guinea,GIN,-,-,142,124,38,551,6,4637,5498,100,58,132,825,11,3315,4441,20333
2017,Guyana,GUY,-,-,0,0,0,0,0,5,5,0,0,0,5,0,11,16,260
2017,Haiti,HTI,-,-,0,35,51,241,27,1580,1934,9,35,41,226,39,1929,2279,28424
2017,"China, Hong Kong SAR",HKG,-,-,0,0,0,0,0,0,0,0,0,0,0,0,0,0,11
2017,Honduras,HND,-,-,5,8,11,60,0,78,162,0,0,13,55,0,108,176,14424
2017,Croatia,HRV,-,-,0,131,693,7405,5230,41,13500,0,121,638,7610,2675,44,11088,24869
2017,Hungary,HUN,-,-,0,0,0,20,68,32,120,0,0,0,41,137,40,218,3336
2017,Iceland,ISL,-,-,0,0,0,5,0,0,5,0,0,0,0,0,0,0,5
2017,Cote d'Ivoire,CIV,-,-,1610,2630,1872,6685,393,1836,15026,1645,2639,1901,7214,311,2069,15779,40009
2017,India,IND,-,-,11,22,17,105,5,67,227,16,22,16,181,13,160,408,7926
2017,Indonesia,IDN,-,-,0,0,0,22,0,6,28,0,5,0,0,7,0,12,12485
2017,Iran (Islamic Rep. of),IRN,-,-,1059,1801,1634,16196,1479,1598,23767,1024,1973,1950,26469,2035,2159,35610,118639
2017,Iraq,IRQ,-,-,9329,17506,12600,60674,7130,4455,111694,10086,19265,15332,85375,6708,4976,141742,362536
2017,Israel,ISR,-,-,0,5,0,8,0,12,25,0,0,12,13,0,0,25,469
2017,Italy,ITA,-,-,6,0,0,5,0,0,11,0,0,0,6,0,5,11,52
2017,Jamaica,JAM,-,-,0,0,0,5,0,5,10,0,0,0,65,0,9,74,2224
2017,Jordan,JOR,-,-,13,19,13,253,9,28,335,13,20,35,85,9,42,204,2119
2017,Japan,JPN,-,-,0,7,5,5,0,0,17,0,6,0,5,0,0,11,44
2017,Kazakhstan,KAZ,-,-,0,11,5,50,35,309,410,0,13,5,65,5,255,343,2406
2017,Kenya,KEN,-,-,361,353,308,895,152,151,2220,427,376,301,652,114,134,2004,7567
2017,Kyrgyzstan,KGZ,-,-,12,34,17,113,11,159,346,8,64,12,105,0,177,366,2771
2017,Rep. of Korea,KOR,-,-,0,0,6,14,0,0,20,0,0,9,16,0,0,25,239
2017,Dem. People's Rep. of Korea,PRK,-,-,0,0,5,32,5,0,42,0,0,0,48,7,0,55,1176
2017,Kuwait,KWT,-,-,0,0,12,26,0,5,43,0,8,7,48,0,72,135,1097
2017,Lao People's Dem. Rep.,LAO,-,-,0,0,0,0,8,3256,3264,0,0,0,30,6,3592,3628,7056
2017,Liberia,LBR,-,-,118,172,288,1123,52,102,1855,128,221,239,1094,36,363,2081,6039
2017,Libya,LBY,-,-,106,128,85,452,9,282,1062,95,184,76,792,21,446,1614,11205
2017,Saint Lucia,LCA,-,-,0,0,0,0,0,0,0,0,0,0,0,0,0,0,995
2017,Lebanon,LBN,-,-,67,91,89,497,59,45,848,81,98,70,447,33,115,844,5301
2017,Lesotho,LSO,-,-,0,0,0,0,0,0,0,0,0,0,0,0,0,0,6
2017,Sri Lanka,LKA,-,-,145,214,154,1419,384,41476,43792,131,217,178,3879,286,48644,53335,115632
2017,Lithuania,LTU,-,-,0,0,5,0,0,0,5,0,0,0,0,0,11,11,73
2017,Latvia,LVA,-,-,0,0,0,5,0,19,24,0,0,0,12,0,19,31,162
2017,Madagascar,MDG,-,-,0,0,0,5,0,110,115,0,0,0,0,0,111,111,292
2017,Mauritania,MRT,-,-,2009,3749,2360,5969,568,1258,15913,2099,3843,2279,5602,690,4368,18881,36525
2017,North Macedonia,MKD,-,-,29,51,50,270,20,173,593,24,55,50,232,26,181,568,1653
2017,Monaco,MCO,-,-,0,0,0,0,0,0,0,0,0,0,0,0,0,0,5
2017,Rep. of Moldova,MDA,-,-,5,11,5,81,7,169,278,0,5,5,67,5,160,242,2339
2017,Maldives,MDV,-,-,0,5,0,0,0,0,5,0,0,0,8,0,0,8,64
2017,Mexico,MEX,-,-,0,0,0,20,0,16,36,0,0,6,13,0,13,32,11679
2017,Marshall Islands,MHL,-,-,0,0,0,0,0,0,0,0,0,0,0,0,0,0,7
2017,Mali,MLI,-,-,12695,17850,9606,28516,2391,3486,74544,12753,17849,9526,17507,2359,902,60896,150305
2017,Malaysia,MYS,-,-,0,0,0,5,0,9,14,0,0,0,10,0,0,10,540
2017,Malawi,MWI,-,-,5,5,0,24,0,0,34,0,5,0,17,0,0,22,434
2017,Mongolia,MNG,-,-,14,10,0,89,6,251,370,11,21,13,52,5,176,278,2227
2017,Morocco,MAR,-,-,49,35,20,298,7,147,556,43,28,34,153,10,349,617,3089
2017,Mozambique,MOZ,-,-,0,0,0,18,0,0,18,0,0,0,6,0,9,15,48
2017,Montenegro,MNE,-,-,0,13,18,124,18,53,226,11,15,17,102,11,38,194,704
2017,Mauritius,MUS,-,-,0,5,0,7,0,11,23,0,0,0,0,0,5,5,130
2017,Myanmar,MMR,-,-,83928,97311,61900,225320,16117,57,484633,87183,102826,63965,213894,14860,276,483004,1156742
2017,Namibia,NAM,-,-,30,51,47,126,0,0,254,29,62,62,481,35,0,669,1368
2017,Nepal,NPL,-,-,0,0,0,22,0,51,73,0,0,5,59,0,87,151,8415
2017,Netherlands,NLD,-,-,5,0,0,6,0,0,11,5,0,0,5,0,0,10,39
2017,Niger,NER,-,-,39,49,58,107,19,19,291,49,78,29,123,9,45,333,1363
2017,Nicaragua,NIC,-,-,0,0,6,60,24,234,324,0,0,0,102,7,327,436,1467
2017,Nigeria,NGA,-,-,18682,25917,11117,41051,2848,1413,101028,18158,23344,10624,30027,3369,734,86256,238977
2017,Niue,NIU,-,-,0,0,0,0,0,0,0,0,0,0,0,0,0,0,19
2017,Norway,NOR,-,-,0,0,0,0,0,0,0,0,5,0,0,0,0,5,15
2017,New Zealand,NZL,-,-,0,0,0,0,0,0,0,0,0,0,8,0,0,8,34
2017,Oman,OMN,-,-,0,0,0,0,0,0,0,9,0,0,0,0,0,9,39
2017,Pakistan,PAK,-,-,6845,15759,3082,10294,960,296,37236,7119,18058,6762,17459,1621,1191,52210,128914
2017,Panama,PAN,-,-,0,0,0,0,0,0,0,0,0,0,0,0,5,5,36
2017,Paraguay,PRY,-,-,0,0,0,8,0,6,14,0,0,0,5,0,0,5,77
2017,Peru,PER,-,-,0,0,0,286,65,145,496,0,0,18,255,70,176,519,2588
2017,Philippines,PHL,-,-,0,0,5,29,5,0,39,0,5,5,0,0,0,10,445
2017,Papua New Guinea,PNG,-,-,0,0,0,0,0,0,0,0,0,0,0,0,0,0,406
2017,Poland,POL,-,-,0,0,5,67,113,70,255,0,0,7,157,317,75,556,1123
2017,Portugal,PRT,-,-,6,0,0,0,0,0,6,0,0,0,0,0,5,5,16
2017,Qatar,QAT,-,-,0,0,0,0,0,0,0,0,0,0,0,0,0,0,31
2017,Romania,ROU,-,-,0,0,5,41,34,71,151,0,5,9,47,85,95,241,1210
2017,South Africa,ZAF,-,-,0,8,7,40,0,9,64,0,0,5,17,12,23,57,461
2017,Russian Federation,RUS,-,-,274,658,541,2553,333,8493,12852,287,687,561,2259,200,7715,11709,61584
2017,Rwanda,RWA,-,-,25248,32464,22172,43512,2485,2139,128020,21946,33413,23693,42932,3261,2360,127605,258986
2017,El Salvador,SLV,-,-,0,15,10,225,33,384,667,0,6,22,234,52,527,841,25876
2017,Saudi Arabia,SAU,-,-,12,9,10,69,0,7,107,6,9,15,31,0,10,71,1219
2017,Serbia and Kosovo: S/RES/1244 (1999),SRB,-,-,130,361,467,4532,997,6718,13205,132,359,543,4308,948,7304,13594,33246
2017,Senegal,SEN,-,-,881,1958,1327,4353,618,746,9883,851,1858,1397,3680,520,362,8668,26584
2017,Seychelles,SYC,-,-,0,0,0,0,0,0,0,0,0,0,0,0,0,0,10
2017,Singapore,SGP,-,-,0,0,0,0,0,0,0,0,7,0,0,0,0,7,48
2017,Sierra Leone,SLE,-,-,62,66,64,348,6,213,759,36,46,53,491,11,716,1353,4496
2017,Solomon Islands,SLB,-,-,0,0,0,8,0,0,8,0,0,0,0,0,0,0,57
2017,Somalia,SOM,-,-,42227,90356,66883,204599,12765,7105,423935,43993,92785,70233,231963,12714,24550,476238,986386
2017,Spain,ESP,-,-,0,5,5,0,0,0,10,6,0,0,0,6,0,12,39
2017,Viet Nam,VNM,-,-,21,46,50,398,170,4050,4735,34,57,57,798,203,4855,6004,334064
2017,Saint Kitts and Nevis,KNA,-,-,0,0,0,0,0,0,0,0,0,0,0,0,0,0,51
2017,Sao Tome and Principe,STP,-,-,0,5,0,10,0,5,20,0,5,0,6,0,0,11,31
2017,Sudan,SDN,-,-,56853,75137,88706,120635,12350,1036,354717,58786,74330,62067,103244,9916,10939,319282,694556
2017,Suriname,SUR,-,-,0,0,0,0,0,0,0,0,0,0,0,0,0,0,17
2017,South Sudan,SSD,-,-,161716,251274,153347,363210,30704,52605,1012856,163275,262621,169991,250241,15305,33201,894634,2439888
2017,Slovakia,SVK,-,-,0,0,0,14,16,59,89,0,0,0,21,34,57,112,913
2017,Slovenia,SVN,-,-,0,0,0,0,0,0,0,0,0,0,0,7,0,7,17
2017,Eswatini,SWZ,-,-,0,0,0,11,0,0,11,0,0,0,9,0,0,9,231
2017,Sweden,SWE,-,-,6,0,0,0,0,0,6,0,0,0,0,0,0,0,14
2017,Switzerland,CHE,-,-,0,0,0,0,0,0,0,0,0,0,0,0,0,0,5
2017,Syrian Arab Rep.,SYR,-,-,184626,255240,146944,581007,40226,9485,1217528,195036,271593,165723,675684,33009,10191,1351236,6310498
2017,United Rep. of Tanzania,TZA,-,-,5,5,5,34,0,20,69,6,0,0,22,0,30,58,655
2017,Turks and Caicos Islands,TCA,-,-,0,0,0,0,0,0,0,0,0,0,0,0,0,0,14
2017,Thailand,THA,-,-,0,0,5,22,0,0,27,0,0,0,9,5,6,20,164
2017,Tajikistan,TJK,-,-,42,49,17,147,8,34,297,35,38,36,172,8,41,330,1369
2017,Turkmenistan,TKM,-,-,0,7,5,25,0,12,49,0,5,0,19,0,19,43,365
2017,Timor-Leste,TLS,-,-,0,0,0,0,0,0,0,0,0,0,0,0,0,0,13
2017,Togo,TGO,-,-,129,345,260,1204,92,543,2573,135,340,266,1894,133,761,3529,8115
2017,Tonga,TON,-,-,0,0,0,0,0,0,0,0,0,0,0,0,0,0,34
2017,Trinidad and Tobago,TTO,-,-,0,0,0,0,0,0,0,0,0,0,0,0,0,0,310
2017,Tunisia,TUN,-,-,9,18,5,71,6,256,365,7,13,5,82,11,287,405,1826
2017,Türkiye,TUR,-,-,516,1252,1657,11284,2423,4961,22093,556,1360,1812,14440,2144,8742,29054,61383
2017,United Arab Emirates,ARE,-,-,7,0,0,5,0,0,12,0,13,0,8,0,0,21,137
2017,Uganda,UGA,-,-,38,75,55,278,8,226,680,39,81,78,385,23,476,1082,6409
2017,Ukraine,UKR,-,-,50,120,53,570,132,902,1827,50,96,71,358,62,725,1362,139581
2017,Uruguay,URY,-,-,0,0,0,0,0,0,0,0,0,0,0,0,0,0,12
2017,United States of America,USA,-,-,5,11,31,25,7,0,79,5,14,21,24,9,0,73,310
2017,Uzbekistan,UZB,-,-,0,15,8,62,14,165,264,5,24,31,88,7,157,312,3405
2017,Saint Vincent and the Grenadines,VCT,-,-,0,0,5,0,0,0,5,0,5,0,0,0,0,5,1311
2017,Venezuela (Bolivarian Republic of),VEN,-,-,12,15,27,59,12,210,335,17,5,12,98,5,261,398,9272
2017,Western Sahara,ESH,-,-,0,0,0,26,0,44152,44178,0,0,0,155,0,46385,46540,116762
2017,Yemen,YEM,-,-,699,1537,1357,4022,346,190,8151,721,1669,1515,6840,426,237,11408,23555
2017,Zambia,ZMB,-,-,0,0,0,12,0,44,56,0,0,0,0,0,27,27,260
2017,Zimbabwe,ZWE,-,-,64,83,51,355,13,2001,2567,71,94,58,414,11,2608,3256,17420
2017,Stateless,XXA,-,-,307,492,335,1918,111,350,3513,272,624,470,4229,199,190,5984,53352
2017,Tibetan,TIB,-,-,0,0,0,7003,0,0,7003,0,0,0,6506,0,0,6506,13531
2017,Curacao ,CUW,-,-,0,0,0,0,0,0,0,0,0,0,0,0,0,0,35
2017,Unknown ,,-,-,1662,1763,1135,6057,414,726,11757,1716,2003,1667,13138,504,775,19803,202190
2018,Afghanistan,AFG,-,-,88224,159897,113841,340502,29211,2867,734542,93038,171509,123902,429376,46734,17896,882455,2681267
2018,Albania,ALB,-,-,42,89,80,520,32,2663,3426,42,101,97,446,30,2489,3205,13512
2018,Algeria,DZA,-,-,32,27,38,261,11,854,1223,31,57,28,342,36,1012,1506,4181
2018,Angola,AGO,-,-,94,193,155,765,64,1562,2833,72,192,180,676,132,2013,3265,8243
2018,Antigua and Barbuda,ATG,-,-,0,5,0,7,0,0,12,0,0,0,5,0,0,5,107
2018,Egypt,EGY,-,-,143,254,173,738,67,305,1680,142,271,169,1158,65,779,2584,24850
2018,Argentina,ARG,-,-,0,0,0,6,0,5,11,0,0,0,0,8,0,8,112
2018,Armenia,ARM,-,-,75,98,98,840,245,2142,3498,76,153,114,849,183,2065,3440,11040
2018,Australia,AUS,-,-,0,0,0,0,0,0,0,0,0,5,0,0,0,5,10
2018,Austria,AUT,-,-,0,5,0,5,0,0,10,0,0,0,0,0,0,0,24
2018,Azerbaijan,AZE,-,-,116,219,125,1690,524,1519,4193,136,262,177,1630,331,1440,3976,11246
2018,Bahrain,BHR,-,-,0,16,28,13,0,0,57,7,6,5,49,0,10,77,540
2018,Barbados,BRB,-,-,0,0,5,6,0,0,11,0,0,0,10,0,0,10,211
2018,Burundi,BDI,-,-,36763,40133,25936,77453,4739,417,185441,37301,41224,26164,87018,4215,498,196420,387850
2018,Belgium,BEL,-,-,0,0,0,5,0,0,5,0,0,0,0,0,0,0,50
2018,Benin,BEN,-,-,5,0,8,42,0,33,88,7,5,5,51,0,28,96,659
2018,Bangladesh,BGD,-,-,40,65,34,218,5,881,1243,22,59,39,753,18,4781,5672,21022
2018,Bahamas,BHS,-,-,0,0,0,8,0,0,8,0,0,0,18,0,0,18,421
2018,Bhutan,BTN,-,-,241,435,381,1721,307,21,3106,257,456,404,2016,445,102,3680,7100
2018,Burkina Faso,BFA,-,-,928,1144,457,1885,86,150,4650,928,1175,458,1349,183,91,4184,11447
2018,Belarus,BLR,-,-,11,19,10,97,9,252,398,7,22,0,82,13,275,399,3526
2018,Bolivia (Plurinational State of),BOL,-,-,0,7,5,5,0,18,35,0,0,0,16,0,20,36,502
2018,Botswana,BWA,-,-,0,0,7,14,0,0,21,0,0,0,5,0,0,5,289
2018,Brazil,BRA,-,-,0,0,10,26,0,8,44,0,0,6,14,0,7,27,1038
2018,Bosnia and Herzegovina,BIH,-,-,20,47,101,2314,3394,2715,8591,19,52,102,2242,1897,2844,7156,16956
2018,Bulgaria,BGR,-,-,0,0,6,16,11,27,60,0,5,0,20,36,43,104,620
2018,Belize,BLZ,-,-,0,0,5,0,0,0,5,0,0,0,0,0,0,0,68
2018,Cambodia,KHM,-,-,8,10,22,141,5,5660,5846,7,19,9,101,11,5840,5987,12139
2018,Canada,CAN,-,-,0,0,8,6,0,0,14,0,0,5,5,0,0,10,81
2018,Central African Rep.,CAF,-,-,48782,73889,41984,134336,9192,1426,309609,49569,72920,41694,103809,8446,1546,277984,590858
2018,Cayman Islands,CYM,-,-,0,0,0,0,0,0,0,0,0,0,0,0,0,0,6
2018,Chad,TCD,-,-,580,973,592,1691,145,528,4509,596,761,651,1720,158,1110,4996,10895
2018,China,CHN,-,-,156,157,93,1599,116,2793,4914,178,168,110,2052,137,3913,6558,212039
2018,Chile,CHL,-,-,0,0,5,53,37,44,139,0,0,0,49,75,37,161,479
2018,Cameroon,CMR,-,-,2666,3627,2191,9753,824,478,19539,2674,3492,1892,6617,455,841,15971,45118
2018,Congo,COG,-,-,90,94,119,449,14,1707,2473,77,151,94,506,45,1845,2718,13354
2018,Dem. Rep. of the Congo,COD,-,-,57070,73925,47111,147738,10042,8047,343933,57330,74201,47521,131888,8205,8771,327916,720302
2018,Comoros,COM,-,-,0,0,0,0,0,210,210,0,0,0,0,0,373,373,624
2018,Colombia,COL,-,-,4918,6801,8508,13285,1727,332,35571,5341,7377,9204,14282,1854,415,38473,138583
2018,Costa Rica,CRI,-,-,0,0,5,0,0,5,10,0,0,0,0,0,0,0,207
2018,Cuba,CUB,-,-,5,10,22,126,35,74,272,5,5,15,315,35,124,499,5488
2018,Cabo Verde,CPV,-,-,0,0,0,0,0,0,0,0,0,0,0,0,0,0,10
2018,Cyprus,CYP,-,-,0,0,0,0,0,0,0,0,0,0,0,0,0,0,7
2018,Czechia,CZE,-,-,0,0,0,94,203,16,313,0,0,6,131,350,16,503,1236
2018,Djibouti,DJI,-,-,13,19,16,74,5,198,325,0,26,18,73,0,125,242,2124
2018,Dominica,DMA,-,-,0,0,0,0,0,0,0,0,0,0,0,0,0,0,36
2018,Dominican Rep.,DOM,-,-,0,0,0,23,0,44,67,0,5,0,8,0,12,25,472
2018,Ecuador,ECU,-,-,6,12,13,12,0,12,55,6,13,0,7,0,13,39,1424
2018,Equatorial Guinea,GNQ,-,-,0,5,5,16,0,17,43,0,0,0,12,5,15,32,140
2018,Eritrea,ERI,-,-,11586,21635,17080,93303,5810,11940,161354,12316,22752,22787,154011,6908,17531,236305,507260
2018,Estonia,EST,-,-,0,0,0,0,0,7,7,0,0,5,0,0,0,5,281
2018,Ethiopia,ETH,-,-,3274,4309,3006,15062,570,1083,27304,3303,4668,3187,15053,695,1125,28031,92232
2018,Fiji,FJI,-,-,0,0,0,0,0,0,0,0,0,0,0,0,0,0,675
2018,Finland,FIN,-,-,0,0,0,0,0,0,0,0,0,0,0,0,0,0,5
2018,France,FRA,-,-,0,0,0,5,0,0,5,0,0,0,5,5,5,15,59
2018,Gabon,GAB,-,-,0,0,0,10,0,97,107,0,0,0,5,0,82,87,342
2018,Gambia,GMB,-,-,56,39,14,259,0,192,560,36,30,40,512,0,117,735,17237
2018,Palestinian,PSE,-,-,341,970,833,4709,865,349,8067,328,1061,884,5255,985,591,9104,100728
2018,United Kingdom of Great Britain and Northern Ireland,GBR,-,-,0,6,0,6,0,0,12,0,5,5,9,0,0,19,84
2018,Georgia,GEO,-,-,20,46,40,347,58,1688,2199,24,77,44,323,35,1559,2062,6983
2018,Germany,DEU,-,-,0,0,0,0,0,5,5,0,0,0,0,0,0,0,61
2018,Ghana,GHA,-,-,1231,1425,561,2434,296,199,6146,1189,1534,592,1046,152,320,4833,18071
2018,Guinea-Bissau,GNB,-,-,7,5,5,42,0,309,368,5,6,5,80,0,598,694,2043
2018,Greece,GRC,-,-,0,0,0,0,6,0,6,0,0,0,11,32,0,43,107
2018,Grenada,GRD,-,-,0,0,0,0,0,0,0,0,0,0,0,0,0,0,96
2018,Guatemala,GTM,-,-,0,0,5,21,0,5,31,0,6,7,46,0,9,68,19128
2018,Guinea,GIN,-,-,217,151,47,821,12,5510,6758,161,87,155,1137,13,3804,5357,23493
2018,Guyana,GUY,-,-,0,0,5,0,0,5,10,0,0,0,0,0,12,12,283
2018,Haiti,HTI,-,-,11,15,30,241,36,1619,1952,15,19,12,206,42,1948,2242,27517
2018,"China, Hong Kong SAR",HKG,-,-,0,0,0,0,0,0,0,0,6,0,0,0,0,6,11
2018,Honduras,HND,-,-,5,25,14,114,5,5,168,0,18,19,136,0,5,178,18857
2018,Croatia,HRV,-,-,0,14,191,5531,7949,42,13727,0,0,263,5377,4376,36,10052,24105
2018,Hungary,HUN,-,-,6,20,29,137,66,20,278,8,11,27,151,147,41,385,3927
2018,Iceland,ISL,-,-,0,0,0,5,0,0,5,0,0,0,0,0,0,0,5
2018,Cote d'Ivoire,CIV,-,-,1300,2231,1661,6095,385,2608,14280,1284,2273,1659,6601,308,1677,13802,38316
2018,India,IND,-,-,18,34,41,224,6,70,393,23,40,32,309,20,161,585,9586
2018,Indonesia,IDN,-,-,5,5,0,900,0,6,916,7,5,9,0,8,7,36,12148
2018,Iran (Islamic Rep. of),IRN,-,-,1196,1983,1753,17587,1609,1473,25601,1116,2132,2015,28233,2198,2448,38142,129941
2018,Iraq,IRQ,-,-,8500,18570,13700,64042,7490,4797,117099,8818,20418,15808,88908,6971,5475,146398,372332
2018,Israel,ISR,-,-,0,6,0,22,0,12,40,0,9,5,17,0,0,31,492
2018,Italy,ITA,-,-,5,6,0,6,0,5,22,0,5,0,5,0,0,10,69
2018,Jamaica,JAM,-,-,0,0,12,64,0,5,81,0,7,5,130,0,11,153,2448
2018,Jordan,JOR,-,-,20,37,18,338,11,37,461,22,32,36,130,10,35,265,2430
2018,Japan,JPN,-,-,0,5,5,5,0,0,15,0,0,9,0,0,0,9,42
2018,Kazakhstan,KAZ,-,-,5,12,5,58,32,327,439,0,12,5,63,7,257,344,2520
2018,Kenya,KEN,-,-,362,353,313,942,148,80,2198,417,374,328,657,120,66,1962,7480
2018,Kyrgyzstan,KGZ,-,-,5,44,35,117,13,154,368,6,59,22,111,0,169,367,2934
2018,Rep. of Korea,KOR,-,-,0,0,0,39,6,0,45,0,0,0,47,7,0,54,274
2018,Dem. People's Rep. of Korea,PRK,-,-,0,0,5,13,0,0,18,0,0,5,18,0,0,23,797
2018,Kuwait,KWT,-,-,5,5,5,35,0,22,72,0,9,11,47,0,99,166,1251
2018,Lao People's Dem. Rep.,LAO,-,-,0,0,0,0,8,3177,3185,0,0,0,36,7,3562,3605,6943
2018,Liberia,LBR,-,-,73,145,153,732,42,82,1227,90,155,144,627,38,173,1227,5508
2018,Libya,LBY,-,-,109,203,108,546,11,304,1281,132,234,110,967,30,599,2072,13868
2018,Saint Lucia,LCA,-,-,0,0,15,30,0,0,45,0,6,9,24,0,0,39,1025
2018,Lebanon,LBN,-,-,84,117,85,685,68,47,1086,78,144,87,527,39,105,980,5620
2018,Lesotho,LSO,-,-,0,0,0,0,0,0,0,0,0,0,0,0,0,0,6
2018,Sri Lanka,LKA,-,-,104,159,127,1177,268,9568,11403,112,179,150,3349,269,18754,22813,113955
2018,Lithuania,LTU,-,-,0,0,5,5,0,0,10,0,0,0,0,0,9,9,66
2018,Latvia,LVA,-,-,0,0,0,0,0,16,16,0,0,0,13,0,17,30,152
2018,Madagascar,MDG,-,-,0,0,0,12,0,112,124,0,5,0,0,0,106,111,298
2018,Mauritania,MRT,-,-,1190,3893,2587,6566,650,1320,16206,1272,3943,2566,6108,776,4099,18764,37050
2018,North Macedonia,MKD,-,-,24,54,48,295,23,181,625,25,61,46,238,28,186,584,1721
2018,Monaco,MCO,-,-,0,0,0,0,0,0,0,0,0,0,0,0,0,0,5
2018,Rep. of Moldova,MDA,-,-,0,13,10,72,7,160,262,0,7,6,59,0,159,231,2397
2018,Maldives,MDV,-,-,0,0,5,0,0,5,10,0,0,0,0,6,0,6,74
2018,Mexico,MEX,-,-,0,5,0,50,0,10,65,0,12,6,44,0,14,76,12870
2018,Marshall Islands,MHL,-,-,0,0,0,0,0,0,0,0,0,0,0,0,0,0,7
2018,Mali,MLI,-,-,11566,18113,11270,30684,2569,3802,78004,11845,18007,11027,19174,2577,981,63611,158267
2018,Malaysia,MYS,-,-,0,0,0,8,0,5,13,0,0,0,13,0,6,19,817
2018,Malawi,MWI,-,-,0,9,0,36,0,0,45,0,8,0,27,0,0,35,472
2018,Mongolia,MNG,-,-,20,15,0,114,7,265,421,10,41,15,70,5,185,326,2249
2018,Morocco,MAR,-,-,57,42,20,364,9,211,703,59,41,24,214,11,449,798,3873
2018,Mozambique,MOZ,-,-,0,0,0,19,0,5,24,0,0,0,7,0,6,13,57
2018,Malta,MLT,-,-,0,0,0,0,0,0,0,0,0,0,0,0,0,0,5
2018,Montenegro,MNE,-,-,5,12,15,131,20,50,233,12,13,21,96,13,44,199,715
2018,Mauritius,MUS,-,-,0,5,0,8,0,16,29,0,0,0,0,0,10,10,156
2018,Myanmar,MMR,-,-,96788,114190,71805,266578,19552,57,568970,100721,120257,73440,258400,17950,281,571049,1145149
2018,Namibia,NAM,-,-,25,48,53,118,0,0,244,27,61,61,475,39,0,663,1331
2018,Nepal,NPL,-,-,5,9,5,71,0,54,144,7,0,15,113,0,97,232,8590
2018,Netherlands,NLD,-,-,10,0,0,6,0,0,16,9,0,0,5,0,0,14,41
2018,Niger,NER,-,-,211,217,107,365,28,31,959,195,222,82,298,19,58,874,2715
2018,Nicaragua,NIC,-,-,0,0,0,12,0,0,12,0,0,0,20,0,8,28,1671
2018,Nigeria,NGA,-,-,21756,33875,15040,52989,4416,1752,129828,22086,32854,14839,37661,4854,799,113093,276834
2018,Niue,NIU,-,-,0,0,0,0,0,0,0,0,0,0,0,0,0,0,19
2018,Norway,NOR,-,-,0,0,0,0,0,0,0,0,0,0,0,0,0,0,5
2018,New Zealand,NZL,-,-,0,0,0,0,0,0,0,0,0,0,8,0,0,8,34
2018,Oman,OMN,-,-,0,0,0,0,0,0,0,0,9,0,0,0,0,9,42
2018,Pakistan,PAK,-,-,8012,9289,5492,19475,2068,313,44649,7277,9556,5028,19042,2444,1445,44792,132248
2018,Panama,PAN,-,-,0,0,0,0,0,0,0,0,0,0,0,0,0,0,44
2018,Paraguay,PRY,-,-,5,0,0,8,0,6,19,0,0,0,5,0,0,5,73
2018,Peru,PER,-,-,0,5,0,248,65,140,458,0,5,0,234,66,183,488,2579
2018,Philippines,PHL,-,-,6,5,0,44,5,5,65,5,17,0,5,0,0,27,522
2018,Papua New Guinea,PNG,-,-,0,0,0,0,0,0,0,0,0,0,0,0,0,0,424
2018,Poland,POL,-,-,0,0,5,67,118,65,255,0,0,6,134,325,74,539,1085
2018,Portugal,PRT,-,-,0,5,0,0,0,5,10,0,0,0,0,0,0,0,20
2018,Qatar,QAT,-,-,0,0,0,0,0,0,0,0,0,0,0,0,0,0,30
2018,Romania,ROU,-,-,0,0,10,34,39,70,153,0,5,7,51,82,90,235,1155
2018,South Africa,ZAF,-,-,0,13,11,38,0,19,81,0,13,0,23,7,23,66,482
2018,Russian Federation,RUS,-,-,293,788,603,2890,375,8561,13510,332,796,677,2469,230,7737,12241,61457
2018,Rwanda,RWA,-,-,24411,31223,21186,41366,2449,1579,122214,21167,32129,22643,39811,3179,1457,120386,247469
2018,El Salvador,SLV,-,-,5,18,23,235,17,23,321,6,22,30,211,11,32,312,32562
2018,Saudi Arabia,SAU,-,-,6,22,12,106,0,7,153,5,38,11,58,0,5,117,1492
2018,Serbia and Kosovo: S/RES/1244 (1999),SRB,-,-,101,349,425,4439,1047,6901,13262,129,357,454,4184,994,7469,13587,32368
2018,Senegal,SEN,-,-,192,432,356,964,108,897,2949,227,431,326,955,161,476,2576,18208
2018,Seychelles,SYC,-,-,0,0,0,0,0,0,0,0,0,0,0,0,0,0,15
2018,Singapore,SGP,-,-,0,0,0,0,0,0,0,0,8,0,0,0,0,8,46
2018,Sierra Leone,SLE,-,-,70,81,74,414,6,216,861,58,56,65,523,13,372,1087,4846
2018,Solomon Islands,SLB,-,-,0,0,0,6,0,0,6,0,0,0,0,0,0,0,33
2018,Somalia,SOM,-,-,39511,83385,64813,200967,12488,1873,403037,40931,85134,67357,230167,12605,3227,439421,949637
2018,Spain,ESP,-,-,0,5,0,0,0,0,5,0,5,0,0,7,5,17,46
2018,Viet Nam,VNM,-,-,32,79,57,444,182,3877,4671,51,80,51,801,227,4875,6085,334464
2018,Saint Kitts and Nevis,KNA,-,-,0,0,0,0,0,0,0,0,0,0,5,0,0,5,58
2018,Sao Tome and Principe,STP,-,-,0,5,0,10,0,5,20,0,5,0,6,0,0,11,31
2018,Sudan,SDN,-,-,58862,84995,56047,154632,12741,1287,368564,61006,85901,54174,109110,10299,13573,334063,724787
2018,Suriname,SUR,-,-,0,0,0,0,0,5,5,0,0,0,0,0,0,0,22
2018,South Sudan,SSD,-,-,199079,304948,181043,454065,44631,19924,1203690,202322,311776,199976,324028,26854,15916,1080872,2285301
2018,Slovakia,SVK,-,-,0,13,10,46,17,57,143,0,13,9,65,37,56,180,1218
2018,Slovenia,SVN,-,-,0,0,0,0,0,0,0,0,0,0,0,6,0,6,19
2018,Eswatini,SWZ,-,-,0,0,0,17,0,0,17,0,0,5,8,0,0,13,237
2018,Sweden,SWE,-,-,8,0,0,0,0,0,8,0,0,0,0,0,0,0,16
2018,Switzerland,CHE,-,-,0,0,0,0,0,0,0,0,0,0,0,0,0,0,5
2018,Syrian Arab Rep.,SYR,-,-,459831,567368,345384,1403746,100663,10925,2887917,490262,604468,393150,1749080,89512,13412,3339884,6654374
2018,United Rep. of Tanzania,TZA,-,-,8,15,10,38,0,0,71,6,18,6,48,0,9,87,723
2018,Turks and Caicos Islands,TCA,-,-,0,0,0,0,0,0,0,0,0,0,0,0,0,0,14
2018,Thailand,THA,-,-,0,0,0,52,0,0,52,0,0,0,8,7,6,21,183
2018,Tajikistan,TJK,-,-,47,71,25,195,10,32,380,55,61,37,237,8,34,432,1695
2018,Turkmenistan,TKM,-,-,8,6,10,26,5,17,72,5,13,0,22,0,11,51,457
2018,Timor-Leste,TLS,-,-,0,0,0,0,0,0,0,0,0,0,0,0,0,0,12
2018,Togo,TGO,-,-,102,333,275,1222,104,507,2543,107,325,258,1913,143,800,3546,8029
2018,Tonga,TON,-,-,0,0,0,0,0,0,0,0,0,0,0,0,0,0,32
2018,Trinidad and Tobago,TTO,-,-,0,0,0,7,0,0,7,5,0,0,11,0,0,16,323
2018,Tunisia,TUN,-,-,10,22,10,102,0,184,328,9,16,10,107,7,367,516,1985
2018,Türkiye,TUR,-,-,735,1507,1789,12359,2461,4261,23112,765,1588,1937,16083,2258,10000,32631,68900
2018,United Arab Emirates,ARE,-,-,5,5,0,7,0,0,17,0,6,6,10,0,0,22,169
2018,Uganda,UGA,-,-,43,108,57,405,8,66,687,60,95,66,572,28,94,915,7034
2018,Ukraine,UKR,-,-,62,154,86,782,180,958,2222,55,145,74,502,85,765,1626,93248
2018,Uruguay,URY,-,-,0,0,0,0,0,0,0,0,0,0,0,0,0,0,7
2018,United States of America,USA,-,-,25,19,24,29,11,0,108,16,20,25,30,10,0,101,332
2018,Uzbekistan,UZB,-,-,5,26,16,91,14,143,295,10,29,23,102,7,118,289,3276
2018,Saint Vincent and the Grenadines,VCT,-,-,0,6,11,44,0,0,61,0,5,7,23,0,0,35,1258
2018,Venezuela (Bolivarian Republic of),VEN,-,-,14,36,46,235,16,169,516,38,47,28,268,10,135,526,21047
2018,Western Sahara,ESH,-,-,0,0,0,31,0,98,129,0,0,0,114,0,484,598,116790
2018,Yemen,YEM,-,-,810,1705,1327,5381,484,223,9930,846,1848,1525,10795,620,345,15979,31145
2018,Zambia,ZMB,-,-,0,0,0,8,0,5,13,0,0,0,0,0,0,0,266
2018,Zimbabwe,ZWE,-,-,57,91,67,461,16,26,718,73,91,70,460,16,27,737,15618
2018,Stateless,XXA,-,-,328,581,420,2227,142,162,3860,337,699,535,4566,233,353,6723,55765
2018,Tibetan,TIB,-,-,0,0,0,7003,0,0,7003,0,0,0,6506,0,0,6506,13527
2018,Curacao ,CUW,-,-,0,0,0,0,0,0,0,0,0,0,0,0,0,0,35
2018,Unknown ,,-,-,1746,1854,1262,6700,476,480,12518,1866,2100,1744,14184,596,868,21358,216540
2019,Afghanistan,AFG,-,-,70622,161875,113571,351331,29013,2663,729075,75005,173043,122300,445139,46811,22750,885048,2727556
2019,Albania,ALB,-,-,38,97,94,546,33,3061,3869,58,96,95,421,38,2768,3476,15027
2019,Algeria,DZA,-,-,33,52,21,243,11,917,1277,33,58,31,315,39,1080,1556,4514
2019,Angola,AGO,-,-,58,184,131,680,60,1649,2762,82,155,144,562,122,2053,3118,8176
2019,Antigua and Barbuda,ATG,-,-,0,0,0,0,0,0,0,0,0,0,0,0,0,0,117
2019,Egypt,EGY,-,-,130,223,165,600,24,294,1436,107,255,160,1071,46,802,2441,27416
2019,Argentina,ARG,-,-,0,0,0,8,0,5,13,0,0,0,0,7,0,7,99
2019,Armenia,ARM,-,-,74,114,91,873,274,2165,3591,72,159,119,921,198,2133,3602,10962
2019,Australia,AUS,-,-,0,5,0,0,0,0,5,0,0,5,0,0,0,5,20
2019,Austria,AUT,-,-,0,5,0,0,0,0,5,0,0,0,0,0,0,0,18
2019,Azerbaijan,AZE,-,-,110,231,144,1667,528,1531,4211,131,268,190,1558,338,1483,3968,11626
2019,Bahrain,BHR,-,-,5,11,18,14,0,0,48,7,9,5,49,0,10,80,557
2019,Barbados,BRB,-,-,0,0,0,0,0,0,0,0,0,0,0,0,0,0,243
2019,Burundi,BDI,-,-,36253,38068,25308,77729,4565,493,182416,36049,39457,25460,84644,4265,596,190471,380900
2019,Belgium,BEL,-,-,0,0,0,6,0,0,6,0,0,0,0,0,0,0,34
2019,Benin,BEN,-,-,14,0,0,44,0,44,102,6,5,0,46,0,32,89,721
2019,Bangladesh,BGD,-,-,21,16,8,108,5,989,1147,20,25,27,709,13,5172,5966,22766
2019,Bahamas,BHS,-,-,0,0,0,0,0,0,0,0,0,0,0,0,0,0,501
2019,Bhutan,BTN,-,-,224,400,357,1679,320,22,3002,235,428,389,1941,453,104,3550,6839
2019,Burkina Faso,BFA,-,-,778,1232,485,1894,93,173,4655,754,1264,503,1368,192,110,4191,11733
2019,Belarus,BLR,-,-,5,22,5,86,12,256,386,5,11,8,92,14,292,422,3425
2019,Bolivia (Plurinational State of),BOL,-,-,0,0,5,7,0,18,30,0,0,0,22,0,20,42,514
2019,Botswana,BWA,-,-,0,0,0,10,0,0,10,0,5,0,0,0,0,5,228
2019,Brazil,BRA,-,-,0,0,9,21,5,11,46,0,0,0,9,0,12,21,1399
2019,Bosnia and Herzegovina,BIH,-,-,14,42,44,707,211,1986,3004,18,45,38,567,144,2130,2942,16556
2019,Bulgaria,BGR,-,-,0,7,0,15,11,27,60,0,5,0,10,33,43,91,566
2019,Belize,BLZ,-,-,0,0,0,0,0,0,0,0,0,0,0,0,0,0,73
2019,Cambodia,KHM,-,-,7,8,25,153,12,5434,5639,8,14,11,117,14,5587,5751,11986
2019,Canada,CAN,-,-,0,7,0,7,0,0,14,0,0,5,5,0,0,10,71
2019,Central African Rep.,CAF,-,-,47545,78627,44922,138516,9849,1687,321146,48031,77924,44504,107274,8879,1732,288344,610152
2019,Cayman Islands,CYM,-,-,0,0,0,0,0,0,0,0,0,0,0,0,0,0,6
2019,Chad,TCD,-,-,494,726,1121,1333,145,643,4462,511,685,940,1567,153,1254,5110,11163
2019,China,CHN,-,-,162,128,78,1334,85,2897,4684,159,149,95,1685,129,4021,6238,212863
2019,Chile,CHL,-,-,0,0,5,52,38,37,132,0,0,0,43,73,30,146,486
2019,Cameroon,CMR,-,-,4247,5894,3530,14030,1059,556,29316,4404,5717,3362,10561,655,973,25672,66241
2019,Congo,COG,-,-,78,121,99,376,19,1782,2475,59,128,121,515,56,1922,2801,12743
2019,Dem. Rep. of the Congo,COD,-,-,66931,81378,53750,163350,11176,8402,384987,67318,81993,54612,148385,9103,9136,370547,802974
2019,Comoros,COM,-,-,0,5,0,0,0,224,229,0,0,0,0,0,403,403,658
2019,Colombia,COL,-,-,5035,6726,8423,12117,1718,262,34281,5100,6812,8542,12307,1731,325,34817,189254
2019,Costa Rica,CRI,-,-,0,0,5,0,0,5,10,0,0,0,0,0,0,0,206
2019,Cuba,CUB,-,-,0,0,5,102,39,76,222,0,5,5,252,47,201,510,6625
2019,Cabo Verde,CPV,-,-,0,0,0,0,0,0,0,0,0,0,0,0,0,0,10
2019,Czechia,CZE,-,-,0,0,0,74,203,10,287,0,0,0,110,339,14,463,1166
2019,Denmark,DNK,-,-,0,0,0,0,0,0,0,0,0,0,0,0,0,0,5
2019,Djibouti,DJI,-,-,5,7,5,29,0,210,256,0,15,8,30,0,132,185,2351
2019,Dominica,DMA,-,-,0,0,0,0,0,5,5,0,0,0,0,0,0,0,50
2019,Dominican Rep.,DOM,-,-,0,0,0,9,0,54,63,0,0,0,0,0,22,22,546
2019,Ecuador,ECU,-,-,0,5,12,11,0,11,39,0,0,14,7,0,13,34,1644
2019,Equatorial Guinea,GNQ,-,-,0,5,0,12,0,21,38,0,0,0,6,6,14,26,156
2019,Eritrea,ERI,-,-,15978,23227,21262,100425,6224,1766,168882,16550,26108,25366,117214,7190,4617,197045,504300
2019,Estonia,EST,-,-,0,0,0,0,0,0,0,0,0,5,0,0,5,10,274
2019,Ethiopia,ETH,-,-,3314,4568,3052,15590,627,752,27903,3480,4806,3297,15327,786,963,28659,93467
2019,Fiji,FJI,-,-,0,0,0,0,0,0,0,0,0,0,0,0,0,0,591
2019,France,FRA,-,-,0,0,0,0,0,0,0,0,0,5,5,5,0,15,50
2019,Gabon,GAB,-,-,0,0,0,7,0,147,154,0,0,0,7,0,113,120,440
2019,Gambia,GMB,-,-,60,43,15,277,0,210,605,49,30,35,576,0,123,813,17813
2019,Palestinian,PSE,-,-,281,723,556,3521,742,35424,41247,253,745,650,4041,800,35684,42173,96253
2019,United Kingdom of Great Britain and Northern Ireland,GBR,-,-,0,0,0,5,0,0,5,7,6,0,7,0,0,20,69
2019,Georgia,GEO,-,-,19,48,31,339,66,1900,2403,22,76,40,306,35,1676,2155,7519
2019,Germany,DEU,-,-,0,0,0,0,0,5,5,0,0,0,0,0,0,0,69
2019,Ghana,GHA,-,-,1249,1419,552,2422,300,198,6140,1199,1534,589,1035,159,319,4835,18432
2019,Guinea-Bissau,GNB,-,-,9,8,0,46,0,319,382,5,5,5,80,0,588,683,2093
2019,Greece,GRC,-,-,0,0,0,0,7,0,7,0,0,0,11,33,0,44,95
2019,Grenada,GRD,-,-,0,0,0,0,0,0,0,0,0,0,0,0,0,0,80
2019,Guatemala,GTM,-,-,0,0,5,14,0,6,25,0,0,7,5,0,9,21,22770
2019,Guinea,GIN,-,-,263,190,86,1022,12,6355,7928,199,164,98,1299,12,4688,6460,26857
2019,Guyana,GUY,-,-,0,0,0,0,0,5,5,0,0,0,0,0,14,14,284
2019,Haiti,HTI,-,-,6,5,13,92,20,1725,1861,9,0,5,82,31,2090,2217,26734
2019,"China, Hong Kong SAR",HKG,-,-,0,0,0,0,0,0,0,0,0,0,0,0,0,0,5
2019,Honduras,HND,-,-,0,13,5,68,0,12,98,0,12,5,68,0,8,93,26351
2019,Croatia,HRV,-,-,0,9,158,2060,860,30,3117,0,0,139,1742,454,26,2361,23793
2019,Hungary,HUN,-,-,0,0,0,12,65,20,97,0,0,0,30,139,34,203,4007
2019,Iceland,ISL,-,-,0,0,0,5,0,0,5,0,0,0,0,0,0,0,5
2019,Cote d'Ivoire,CIV,-,-,1176,1997,1675,6035,383,3626,14892,1173,2020,1527,6614,305,2026,13665,39351
2019,India,IND,-,-,18,14,18,143,8,70,271,19,22,16,174,25,173,429,11787
2019,Indonesia,IDN,-,-,7,5,0,971,5,0,988,0,13,5,6,5,8,37,12039
2019,Iran (Islamic Rep. of),IRN,-,-,1080,1551,1382,14229,1528,1111,20881,1018,1659,1559,24577,2188,1932,32933,128998
2019,Iraq,IRQ,-,-,6488,15555,11492,53115,6308,4190,97148,6943,17139,13111,75482,5837,4747,123259,336274
2019,Israel,ISR,-,-,0,0,5,12,0,7,24,0,0,8,14,5,0,27,452
2019,Italy,ITA,-,-,5,10,0,6,0,0,21,0,7,0,6,0,0,13,76
2019,Jamaica,JAM,-,-,0,0,0,10,0,5,15,0,0,0,67,0,15,82,2529
2019,Jordan,JOR,-,-,17,33,16,256,11,13,346,21,27,24,145,11,24,252,2308
2019,Japan,JPN,-,-,0,0,9,5,0,0,14,0,0,9,0,0,0,9,39
2019,Kazakhstan,KAZ,-,-,0,9,6,51,27,336,429,0,7,6,60,6,278,357,2757
2019,Kenya,KEN,-,-,414,459,318,1038,158,78,2465,495,438,356,721,118,58,2186,7705
2019,Kyrgyzstan,KGZ,-,-,7,22,8,83,6,149,275,5,24,11,53,5,170,268,2963
2019,Rep. of Korea,KOR,-,-,0,0,0,11,5,0,16,0,0,5,9,0,0,14,180
2019,Dem. People's Rep. of Korea,PRK,-,-,0,0,0,30,6,0,36,0,0,0,49,7,0,56,758
2019,Kuwait,KWT,-,-,0,0,14,31,0,34,79,0,0,26,51,0,130,207,1300
2019,Lao People's Dem. Rep.,LAO,-,-,0,0,0,0,7,3045,3052,0,0,0,32,8,3419,3459,6757
2019,Liberia,LBR,-,-,109,177,212,864,48,76,1486,117,180,206,739,51,171,1464,5365
2019,Libya,LBY,-,-,95,203,116,552,16,310,1292,137,255,120,1013,35,718,2278,16033
2019,Saint Lucia,LCA,-,-,0,0,0,0,0,5,5,0,0,0,0,0,0,0,843
2019,Lebanon,LBN,-,-,86,99,94,606,64,45,994,79,163,89,508,41,110,990,5647
2019,Lesotho,LSO,-,-,0,0,0,0,0,0,0,0,0,0,0,0,0,0,6
2019,Sri Lanka,LKA,-,-,115,226,131,1383,403,37825,40083,125,189,194,3513,349,45431,49801,110341
2019,Lithuania,LTU,-,-,0,0,0,5,0,0,5,0,0,0,0,0,6,6,61
2019,Luxembourg,LUX,-,-,0,0,0,5,0,0,5,0,0,0,0,0,0,0,5
2019,Latvia,LVA,-,-,0,0,0,0,0,15,15,0,0,0,13,0,17,30,144
2019,Madagascar,MDG,-,-,0,0,0,5,0,119,124,0,0,0,0,0,105,105,298
2019,Mauritania,MRT,-,-,946,3854,2711,6634,721,1389,16255,1041,3936,2682,6206,814,4286,18965,37423
2019,North Macedonia,MKD,-,-,23,54,57,301,26,191,652,25,67,39,255,33,192,611,1784
2019,Monaco,MCO,-,-,0,0,0,0,0,0,0,0,0,0,0,0,0,0,5
2019,Rep. of Moldova,MDA,-,-,5,14,11,70,7,158,265,5,9,5,66,0,159,244,2427
2019,Maldives,MDV,-,-,0,0,5,0,0,5,10,0,0,0,0,0,0,0,75
2019,Mexico,MEX,-,-,0,0,0,19,0,12,31,0,5,0,15,0,15,35,14621
2019,Marshall Islands,MHL,-,-,0,0,0,0,0,0,0,0,0,0,0,0,0,0,7
2019,Mali,MLI,-,-,11362,18970,12277,31939,2579,4040,81167,11424,18799,11982,19714,2593,1129,65641,164466
2019,Malaysia,MYS,-,-,0,0,0,9,0,0,9,0,0,0,10,0,9,19,906
2019,Malawi,MWI,-,-,0,8,5,43,0,0,56,0,5,5,36,0,0,46,514
2019,Mongolia,MNG,-,-,24,26,5,125,9,275,464,20,45,19,74,5,198,361,2364
2019,Morocco,MAR,-,-,62,45,21,357,10,251,746,62,55,33,212,13,543,918,4642
2019,Mozambique,MOZ,-,-,0,0,0,21,0,5,26,0,0,0,7,0,7,14,77
2019,Malta,MLT,-,-,0,0,0,0,0,0,0,0,0,0,0,0,0,0,5
2019,Montenegro,MNE,-,-,5,11,12,118,22,55,223,8,13,20,85,12,42,180,659
2019,Mauritius,MUS,-,-,0,5,0,7,0,17,29,0,0,0,6,0,11,17,178
2019,Myanmar,MMR,-,-,91771,101159,67151,251251,17036,48,528416,95506,105604,70703,251274,20437,281,543805,1076826
2019,Namibia,NAM,-,-,0,0,0,0,0,0,0,0,0,0,7,0,0,7,459
2019,Nepal,NPL,-,-,0,0,5,29,0,59,93,0,5,0,55,0,91,151,8034
2019,Netherlands,NLD,-,-,9,0,0,7,0,0,16,10,0,0,5,0,0,15,55
2019,Niger,NER,-,-,202,231,99,341,24,36,933,203,210,94,286,21,79,893,3063
2019,Nicaragua,NIC,-,-,0,0,0,19,0,17,36,0,0,0,9,0,28,37,4376
2019,Nigeria,NGA,-,-,22169,36534,16757,54492,4816,2243,137011,21130,34427,15518,41898,4760,979,118712,295578
2019,Niue,NIU,-,-,0,0,0,0,0,0,0,0,0,0,0,0,0,0,19
2019,Norway,NOR,-,-,0,0,0,0,0,0,0,0,0,0,0,0,0,0,5
2019,New Zealand,NZL,-,-,0,0,0,0,0,0,0,0,0,0,8,0,0,8,34
2019,Oman,OMN,-,-,0,0,0,0,0,0,0,0,9,0,0,0,0,9,42
2019,Pakistan,PAK,-,-,8008,9215,5482,19314,2011,311,44341,7318,9554,5024,19329,2381,1549,45155,136902
2019,Panama,PAN,-,-,0,0,0,0,0,0,0,0,0,0,0,0,0,0,45
2019,Paraguay,PRY,-,-,5,0,0,9,0,6,20,0,0,0,7,0,0,7,84
2019,Peru,PER,-,-,0,0,0,231,71,144,446,0,0,0,219,74,182,475,2765
2019,Philippines,PHL,-,-,8,5,5,34,5,5,62,5,22,0,0,0,0,27,554
2019,Papua New Guinea,PNG,-,-,0,0,0,0,0,0,0,0,0,0,0,0,0,0,475
2019,Poland,POL,-,-,0,0,5,42,128,62,237,0,0,5,109,330,70,514,961
2019,Portugal,PRT,-,-,0,0,5,0,0,0,5,0,0,0,0,0,0,0,25
2019,Qatar,QAT,-,-,0,0,5,0,0,0,5,0,0,0,0,0,0,0,36
2019,Romania,ROU,-,-,0,0,5,32,39,61,137,0,5,6,43,79,82,215,1352
2019,South Africa,ZAF,-,-,0,8,5,53,0,26,92,7,12,0,24,9,22,74,441
2019,Russian Federation,RUS,-,-,266,825,678,3008,412,8680,13869,284,850,731,2586,249,7854,12554,62353
2019,Rwanda,RWA,-,-,24229,30927,21100,41228,2458,1569,121511,21051,31856,22502,39751,3241,1431,119832,246407
2019,El Salvador,SLV,-,-,0,12,16,178,9,31,246,0,16,12,147,6,35,216,41816
2019,Saudi Arabia,SAU,-,-,5,22,5,71,0,11,114,5,45,16,37,0,15,118,1721
2019,Serbia and Kosovo: S/RES/1244 (1999),SRB,-,-,69,290,351,4235,1053,6819,12817,92,313,345,3872,983,7327,12932,31251
2019,Senegal,SEN,-,-,160,680,561,1495,245,1058,4199,182,651,554,1391,235,629,3642,17208
2019,Seychelles,SYC,-,-,0,0,0,0,0,0,0,0,0,0,0,0,0,0,15
2019,Singapore,SGP,-,-,0,0,0,0,0,0,0,0,8,0,0,0,0,8,39
2019,Sierra Leone,SLE,-,-,85,95,92,523,11,251,1057,69,92,92,597,27,425,1302,5288
2019,Solomon Islands,SLB,-,-,0,0,0,6,0,0,6,0,0,0,0,0,0,0,34
2019,Somalia,SOM,-,-,45940,68562,56500,190814,12075,1504,375395,47560,70379,59711,229252,12229,3116,422247,901596
2019,Spain,ESP,-,-,0,7,0,0,0,0,7,0,7,0,0,6,0,13,51
2019,Viet Nam,VNM,-,-,36,71,63,439,201,3406,4216,46,78,57,756,249,4335,5521,316441
2019,Saint Kitts and Nevis,KNA,-,-,0,0,0,0,0,0,0,0,0,0,0,0,0,0,57
2019,Sao Tome and Principe,STP,-,-,0,5,0,11,0,5,21,0,0,0,7,0,0,7,28
2019,Sudan,SDN,-,-,59821,83844,56562,156986,12056,1761,371030,61747,85272,55438,109944,9519,16740,338660,734780
2019,Suriname,SUR,-,-,0,0,0,0,0,5,5,0,0,0,0,0,0,0,17
2019,South Sudan,SSD,-,-,186961,286784,186432,461041,44458,11,1165687,189450,294224,203864,351004,29954,72,1068568,2234805
2019,Slovakia,SVK,-,-,0,0,0,10,17,55,82,0,0,0,18,33,52,103,1343
2019,Slovenia,SVN,-,-,0,0,0,0,0,0,0,0,0,0,0,6,0,6,19
2019,Eswatini,SWZ,-,-,0,0,0,11,0,0,11,0,0,0,9,0,0,9,224
2019,Sweden,SWE,-,-,8,0,0,0,0,0,8,0,0,0,0,0,0,0,13
2019,Switzerland,CHE,-,-,0,0,0,0,0,0,0,0,0,0,0,0,0,0,5
2019,Syrian Arab Rep.,SYR,-,-,462998,588910,339973,1400240,98656,9514,2900291,493048,625110,380855,1737201,87994,11203,3335411,6615249
2019,United Rep. of Tanzania,TZA,-,-,9,0,10,34,0,5,58,13,21,0,23,0,5,62,695
2019,Turks and Caicos Islands,TCA,-,-,0,0,0,0,0,0,0,0,0,0,0,0,0,0,14
2019,Thailand,THA,-,-,0,5,0,33,0,0,38,0,0,0,7,7,8,22,173
2019,Tajikistan,TJK,-,-,66,88,32,234,11,30,461,72,81,44,283,8,39,527,1987
2019,Turkmenistan,TKM,-,-,5,7,11,20,5,11,59,6,13,0,26,0,19,64,478
2019,Timor-Leste,TLS,-,-,0,0,0,0,0,0,0,0,0,0,0,0,0,0,17
2019,Togo,TGO,-,-,101,305,295,1238,112,242,2293,104,294,270,1881,164,517,3230,8034
2019,Tonga,TON,-,-,0,0,0,0,0,0,0,0,0,0,0,0,0,0,32
2019,Trinidad and Tobago,TTO,-,-,0,0,0,0,0,0,0,0,0,0,5,0,0,5,307
2019,Tunisia,TUN,-,-,9,16,10,100,5,127,267,12,8,10,101,9,241,381,2068
2019,Türkiye,TUR,-,-,874,1797,1836,13245,2476,3335,23563,934,1836,1961,17581,2378,8540,33230,83239
2019,United Arab Emirates,ARE,-,-,6,6,0,10,0,0,22,0,7,0,10,0,0,17,155
2019,Uganda,UGA,-,-,53,78,45,365,13,69,623,40,85,79,559,45,90,898,7301
2019,Ukraine,UKR,-,-,48,133,65,565,175,1019,2005,50,123,69,350,76,820,1488,59844
2019,Uruguay,URY,-,-,0,0,0,0,0,0,0,0,0,0,0,0,0,0,15
2019,United States of America,USA,-,-,7,10,19,26,10,0,72,5,10,19,28,11,0,73,297
2019,Uzbekistan,UZB,-,-,0,8,11,48,13,126,206,5,24,11,63,8,118,229,3217
2019,Saint Vincent and the Grenadines,VCT,-,-,0,0,0,0,0,0,0,0,0,0,5,0,0,5,979
2019,Venezuela (Bolivarian Republic of),VEN,-,-,22,49,34,278,30,439,852,22,48,28,354,16,420,888,93239
2019,Western Sahara,ESH,-,-,0,0,0,24,0,129,153,0,0,0,94,0,586,680,116908
2019,Yemen,YEM,-,-,792,1772,1421,5672,532,166,10355,819,1895,1585,12321,701,293,17614,36522
2019,Zambia,ZMB,-,-,0,0,0,6,0,0,6,0,0,0,0,0,0,0,259
2019,Zimbabwe,ZWE,-,-,55,106,66,472,10,24,733,53,89,57,452,5,27,683,10045
2019,Stateless,XXA,-,-,1851,2158,1341,5974,287,14,11625,1914,2468,1593,8711,436,31,15153,68784
2019,Tibetan,TIB,-,-,0,0,0,6520,0,0,6520,0,0,0,6020,0,0,6020,12555
2019,Curacao ,CUW,-,-,0,0,0,0,0,0,0,0,0,0,0,0,0,0,35
2019,Unknown ,,-,-,2120,2064,1491,7721,533,86,14015,2238,2283,1941,15349,705,122,22638,183117
2020,Afghanistan,AFG,-,-,56721,160279,119658,372218,30921,2442,742239,60848,170662,129338,468187,49157,5021,883213,2594827
2020,Albania,ALB,-,-,40,94,100,568,38,367,1207,62,104,98,455,40,375,1134,15523
2020,Algeria,DZA,-,-,26,58,22,291,18,68,483,39,50,32,366,46,93,626,4571
2020,Angola,AGO,-,-,58,156,135,698,64,59,1170,60,137,150,568,126,119,1160,8196
2020,Antigua and Barbuda,ATG,-,-,0,0,0,0,0,0,0,0,0,0,0,0,0,0,108
2020,Egypt,EGY,-,-,140,276,211,717,46,85,1475,106,284,222,1156,48,149,1965,26553
2020,Argentina,ARG,-,-,0,0,0,7,0,0,7,0,0,0,0,8,0,8,99
2020,Armenia,ARM,-,-,64,122,99,867,280,90,1522,62,155,140,951,201,148,1657,10334
2020,Australia,AUS,-,-,0,5,0,0,0,0,5,0,0,5,0,0,0,5,20
2020,Austria,AUT,-,-,0,5,0,0,0,0,5,0,0,0,0,0,0,0,18
2020,Azerbaijan,AZE,-,-,5475,5491,5374,35912,10549,257,63058,5737,5996,5845,9167,5358,239,32342,101468
2020,Bahrain,BHR,-,-,0,9,14,14,0,0,37,6,9,5,45,0,0,65,534
2020,Barbados,BRB,-,-,0,0,0,0,0,0,0,0,0,0,0,0,0,0,230
2020,Burundi,BDI,-,-,33648,37698,24778,77929,4608,876,179537,33403,38380,25149,85207,4336,877,187352,372951
2020,Belgium,BEL,-,-,0,0,0,6,0,0,6,0,0,0,0,0,0,0,28
2020,Benin,BEN,-,-,22,0,0,35,0,21,78,8,5,13,51,0,17,94,606
2020,Bangladesh,BGD,-,-,21,30,9,168,5,95,328,24,30,22,1003,16,145,1240,18948
2020,Bahamas,BHS,-,-,0,0,0,0,0,24,24,0,0,0,0,0,20,20,534
2020,Bhutan,BTN,-,-,175,393,350,1717,322,5,2962,180,411,424,1965,459,0,3439,6741
2020,Burkina Faso,BFA,-,-,1209,1611,690,3596,266,56,7428,1159,1525,673,1988,306,50,5701,15694
2020,Belarus,BLR,-,-,0,25,6,85,11,20,147,0,11,13,86,15,47,172,3139
2020,Bolivia (Plurinational State of),BOL,-,-,0,11,0,30,0,0,41,0,5,0,43,14,0,62,535
2020,Botswana,BWA,-,-,0,0,0,12,0,0,12,0,0,5,0,0,0,5,191
2020,Brazil,BRA,-,-,0,5,7,21,5,0,38,6,0,11,14,0,10,41,1548
2020,Bosnia and Herzegovina,BIH,-,-,6,43,44,638,235,24,990,19,34,44,515,149,25,786,15578
2020,Bulgaria,BGR,-,-,0,5,5,14,10,7,41,0,5,0,14,32,10,61,510
2020,Belize,BLZ,-,-,0,0,0,0,0,0,0,0,0,0,0,0,0,0,68
2020,Cambodia,KHM,-,-,9,10,23,165,12,5,224,10,13,13,131,21,8,196,11862
2020,Canada,CAN,-,-,0,0,7,9,0,0,16,0,0,0,7,0,0,7,65
2020,Central African Rep.,CAF,-,-,48589,83582,48137,145899,10787,21,337015,49245,82679,47247,112057,9659,41,300928,642161
2020,Cayman Islands,CYM,-,-,0,0,0,0,0,0,0,0,0,0,0,0,0,0,5
2020,Chad,TCD,-,-,464,711,555,1582,144,44,3500,460,784,529,1765,147,62,3747,10388
2020,China,CHN,-,-,155,116,90,1691,91,596,2739,169,166,100,1981,171,724,3311,175361
2020,Chile,CHL,-,-,0,6,5,51,37,17,116,0,0,0,42,69,27,138,659
2020,Cameroon,CMR,-,-,4450,7526,4553,17346,1493,250,35618,4621,7422,4308,13299,913,357,30920,78481
2020,Congo,COG,-,-,71,231,363,2020,61,17,2763,48,266,366,2538,99,47,3364,12590
2020,Dem. Rep. of the Congo,COD,-,-,65444,88991,59484,179072,12384,882,406257,65716,89403,60211,166146,10318,877,392671,840392
2020,Comoros,COM,-,-,0,5,0,0,0,0,5,0,0,0,0,0,0,0,748
2020,Colombia,COL,-,-,5166,7338,10862,32398,3915,109,59788,5239,7455,11000,34537,4681,96,63008,189866
2020,Costa Rica,CRI,-,-,0,0,5,0,0,0,5,0,0,0,0,0,0,0,208
2020,Cuba,CUB,-,-,5,8,13,276,65,32,399,0,8,11,400,90,56,565,8912
2020,Cabo Verde,CPV,-,-,0,0,0,0,0,0,0,0,0,0,0,0,0,0,5
2020,Czechia,CZE,-,-,0,0,0,57,212,0,269,0,0,0,98,339,5,442,1112
2020,Denmark,DNK,-,-,0,0,0,0,0,0,0,0,0,0,0,0,0,0,5
2020,Djibouti,DJI,-,-,0,12,5,43,0,203,263,0,20,13,60,0,170,263,2419
2020,Dominica,DMA,-,-,0,0,0,5,0,0,5,0,0,0,0,0,0,0,55
2020,Dominican Rep.,DOM,-,-,0,0,0,15,0,0,15,0,0,0,5,0,0,5,550
2020,Ecuador,ECU,-,-,0,0,24,11,0,0,35,0,0,6,5,0,0,11,1689
2020,Equatorial Guinea,GNQ,-,-,0,5,0,11,0,0,16,0,0,0,6,6,0,12,145
2020,Eritrea,ERI,-,-,14657,27481,24293,112840,6591,1545,187407,15646,28554,29847,127976,7461,2427,211911,524738
2020,Estonia,EST,-,-,0,0,0,0,0,0,0,0,0,5,5,0,0,10,277
2020,Ethiopia,ETH,-,-,3955,7153,6220,33864,2396,224,53812,4485,7964,6995,52537,4177,359,76517,151426
2020,Fiji,FJI,-,-,0,0,0,0,0,0,0,0,0,0,0,0,0,0,516
2020,France,FRA,-,-,0,0,0,0,0,0,0,5,0,0,5,6,0,16,49
2020,Gabon,GAB,-,-,0,0,0,7,0,18,25,0,0,0,6,0,13,19,454
2020,Gambia,GMB,-,-,70,58,14,316,0,13,471,56,44,21,666,5,24,816,10579
2020,Palestinian,PSE,-,-,298,786,641,3838,799,35361,41723,274,871,693,4774,844,36061,43517,100153
2020,United Kingdom of Great Britain and Northern Ireland,GBR,-,-,0,0,0,5,0,0,5,6,6,0,5,0,0,17,62
2020,Georgia,GEO,-,-,19,61,41,333,71,98,623,27,90,43,333,45,152,690,7346
2020,Germany,DEU,-,-,0,0,0,0,0,0,0,0,0,0,0,0,0,0,71
2020,Ghana,GHA,-,-,581,1092,938,2247,415,0,5273,34,1025,1309,1409,213,31,4021,13844
2020,Guinea-Bissau,GNB,-,-,5,13,0,51,0,0,69,9,0,5,89,5,7,115,1638
2020,Greece,GRC,-,-,0,0,0,0,6,0,6,0,0,0,9,32,0,41,90
2020,Grenada,GRD,-,-,0,0,0,0,0,0,0,0,0,0,0,0,0,0,70
2020,Guatemala,GTM,-,-,0,0,5,23,0,39,67,0,0,5,12,0,38,55,24544
2020,Guinea,GIN,-,-,357,244,85,1247,14,2232,4179,290,202,72,1428,13,1269,3274,26792
2020,Guyana,GUY,-,-,0,0,0,0,0,5,5,0,0,0,0,0,0,0,267
2020,Haiti,HTI,-,-,0,11,17,302,28,65,423,6,7,5,234,24,103,379,25649
2020,"China, Hong Kong SAR",HKG,-,-,0,0,0,0,0,0,0,0,0,0,0,0,0,0,15
2020,Honduras,HND,-,-,0,12,10,71,0,56,149,0,17,0,89,0,32,138,34456
2020,Croatia,HRV,-,-,0,0,9,77,34,2962,3082,0,0,5,68,97,2155,2325,23451
2020,Hungary,HUN,-,-,26,14,14,168,64,58,344,60,55,15,227,136,81,574,4617
2020,Iceland,ISL,-,-,0,0,0,0,0,0,0,0,5,0,0,0,0,5,5
2020,Cote d'Ivoire,CIV,-,-,1183,2040,1640,6153,443,141,11600,1142,2010,1592,6709,324,125,11902,37525
2020,India,IND,-,-,18,14,23,230,8,75,368,24,27,23,338,33,60,505,12398
2020,Indonesia,IDN,-,-,0,13,0,969,5,0,987,0,12,0,18,6,0,36,13029
2020,Iran (Islamic Rep. of),IRN,-,-,1120,1721,1526,15447,1667,750,22231,1049,1827,1705,25916,2366,1514,34377,135018
2020,Iraq,IRQ,-,-,6284,15480,12111,54222,6630,2267,96994,6713,16863,13421,76272,6123,4802,124194,333200
2020,Israel,ISR,-,-,0,0,6,18,0,0,24,0,7,0,16,5,0,28,373
2020,Italy,ITA,-,-,0,11,0,5,0,0,16,0,7,0,7,0,0,14,62
2020,Jamaica,JAM,-,-,7,0,0,18,0,16,41,9,0,0,122,0,10,141,2526
2020,Jordan,JOR,-,-,21,40,15,316,12,47,451,21,27,41,187,12,54,342,2486
2020,Japan,JPN,-,-,0,0,9,5,0,0,14,0,0,9,0,0,0,9,40
2020,Kazakhstan,KAZ,-,-,0,10,5,54,26,32,127,0,5,7,59,7,42,120,2741
2020,Kenya,KEN,-,-,265,498,360,1182,172,35,2512,312,523,378,879,137,27,2256,7422
2020,Kyrgyzstan,KGZ,-,-,9,26,11,85,9,50,190,6,27,14,72,5,24,148,2883
2020,Rep. of Korea,KOR,-,-,0,0,0,9,5,0,14,0,0,0,12,0,0,12,146
2020,Dem. People's Rep. of Korea,PRK,-,-,0,0,0,29,7,21,57,0,0,0,47,9,22,78,689
2020,Kuwait,KWT,-,-,0,5,14,31,0,0,50,0,5,11,67,0,6,89,1422
2020,Lao People's Dem. Rep.,LAO,-,-,0,0,0,0,7,0,7,0,0,0,30,12,10,52,6665
2020,Liberia,LBR,-,-,79,186,180,907,50,17,1419,71,192,185,813,57,10,1328,5195
2020,Libya,LBY,-,-,110,281,161,709,26,58,1345,136,323,157,1339,57,115,2127,17523
2020,Saint Lucia,LCA,-,-,0,0,0,0,0,0,0,0,0,0,0,0,0,0,726
2020,Lebanon,LBN,-,-,97,106,101,673,72,75,1124,81,168,120,577,45,100,1091,5495
2020,Lesotho,LSO,-,-,0,0,0,0,0,0,0,0,0,0,0,0,0,0,6
2020,Sri Lanka,LKA,-,-,114,224,150,1363,398,30080,32329,133,221,184,3530,388,29184,33640,142664
2020,Lithuania,LTU,-,-,0,0,0,0,0,0,0,0,0,0,5,0,5,10,58
2020,Luxembourg,LUX,-,-,0,0,0,5,0,0,5,0,0,0,0,0,0,0,5
2020,Latvia,LVA,-,-,0,0,0,0,0,0,0,0,0,0,12,0,0,12,143
2020,Madagascar,MDG,-,-,0,0,0,0,0,0,0,0,0,0,0,0,0,0,268
2020,Mauritania,MRT,-,-,253,3792,3817,6382,811,88,15143,290,3994,3753,5884,930,181,15032,37931
2020,North Macedonia,MKD,-,-,17,44,46,288,27,54,476,16,61,46,221,38,74,456,1576
2020,Rep. of Moldova,MDA,-,-,0,12,15,65,7,0,99,5,10,5,71,0,10,101,2206
2020,Maldives,MDV,-,-,0,0,5,0,0,0,5,0,0,0,0,0,0,0,78
2020,Mexico,MEX,-,-,29,49,46,258,0,33,415,30,50,32,249,0,41,402,15398
2020,Marshall Islands,MHL,-,-,0,0,0,0,0,0,0,0,0,0,0,0,0,0,7
2020,Mali,MLI,-,-,11053,19675,12962,33284,2888,54,79916,10840,19614,12422,21418,2792,52,67138,164588
2020,Malaysia,MYS,-,-,0,0,0,12,0,0,12,0,0,0,10,0,0,10,1058
2020,Malawi,MWI,-,-,6,11,5,64,0,0,86,0,6,5,44,0,0,55,514
2020,Mongolia,MNG,-,-,22,34,5,133,12,0,206,21,39,22,78,11,0,171,2277
2020,Morocco,MAR,-,-,44,72,26,354,15,45,556,65,72,33,224,15,102,511,4467
2020,Mozambique,MOZ,-,-,0,0,0,21,0,0,21,0,0,0,7,0,0,7,81
2020,Malta,MLT,-,-,0,0,0,0,0,0,0,0,0,0,0,0,0,0,5
2020,Montenegro,MNE,-,-,0,10,11,117,19,14,171,6,13,10,84,11,5,129,530
2020,Mauritius,MUS,-,-,0,5,0,9,0,0,14,5,0,0,5,0,0,10,176
2020,Myanmar,MMR,-,-,79020,111268,67104,266634,18036,176,542238,82218,115812,72259,265033,21827,227,557376,1103245
2020,Namibia,NAM,-,-,0,0,0,0,0,0,0,0,0,0,0,0,0,0,457
2020,Nepal,NPL,-,-,6,0,0,42,0,21,69,0,6,5,72,0,11,94,7483
2020,Netherlands,NLD,-,-,8,0,0,7,0,0,15,6,5,0,5,0,0,16,51
2020,Niger,NER,-,-,2290,2664,1417,3120,289,52,9832,2138,2441,1039,2144,184,74,8020,18853
2020,Nicaragua,NIC,-,-,0,0,5,48,9,47,109,0,0,0,71,0,47,118,8701
2020,Nigeria,NGA,-,-,25990,47972,21418,67963,5793,115,169251,25335,46103,19979,49930,5665,137,147149,352960
2020,Niue,NIU,-,-,0,0,0,0,0,0,0,0,0,0,0,0,0,0,18
2020,Norway,NOR,-,-,0,0,0,0,0,0,0,0,0,0,0,0,0,0,5
2020,Nauru,NRU,-,-,0,0,0,0,0,0,0,0,0,0,0,0,0,0,5
2020,New Zealand,NZL,-,-,0,0,0,0,0,0,0,0,0,0,8,0,0,8,35
2020,Oman,OMN,-,-,0,0,0,8,0,0,8,0,0,0,0,0,0,0,47
2020,Pakistan,PAK,-,-,8007,9331,5552,19631,2045,235,44801,7343,9604,5096,19963,2450,371,44827,133280
2020,Panama,PAN,-,-,0,0,0,0,0,0,0,0,0,0,0,0,0,0,70
2020,Paraguay,PRY,-,-,0,5,0,9,0,0,14,0,0,5,5,0,0,10,119
2020,Peru,PER,-,-,0,0,0,262,85,0,347,9,0,5,239,91,0,344,2834
2020,Philippines,PHL,-,-,7,0,11,35,6,0,59,0,18,0,19,0,0,37,469
2020,Papua New Guinea,PNG,-,-,0,0,0,0,0,0,0,0,0,0,0,0,0,0,510
2020,Poland,POL,-,-,0,0,5,34,133,26,198,0,0,6,92,327,72,497,910
2020,Portugal,PRT,-,-,7,0,0,0,0,0,7,0,0,0,0,0,0,0,27
2020,Qatar,QAT,-,-,0,0,0,0,0,0,0,0,0,0,5,0,0,5,33
2020,Romania,ROU,-,-,0,0,5,28,32,49,114,0,0,6,44,73,49,172,1343
2020,South Africa,ZAF,-,-,0,13,20,56,5,0,94,5,12,10,31,6,5,69,474
2020,Russian Federation,RUS,-,-,238,827,722,3178,451,1367,6783,250,888,765,2767,284,1457,6411,52742
2020,Rwanda,RWA,-,-,1673,3071,2758,7744,536,104692,120474,1768,3078,2678,7564,806,103438,119332,245781
2020,El Salvador,SLV,-,-,5,15,17,232,9,256,534,13,25,12,200,6,233,489,45640
2020,Saudi Arabia,SAU,-,-,10,26,15,122,0,26,199,12,27,27,104,0,22,192,2003
2020,Serbia and Kosovo: S/RES/1244 (1999),SRB,-,-,61,278,317,3600,1029,526,5811,77,292,310,3329,952,555,5515,29976
2020,Senegal,SEN,-,-,109,640,546,1584,320,114,3313,119,607,571,1518,301,262,3378,13986
2020,Seychelles,SYC,-,-,0,0,0,0,0,0,0,0,0,0,0,0,0,0,10
2020,Singapore,SGP,-,-,0,0,0,0,0,0,0,0,0,8,0,0,0,8,37
2020,Sierra Leone,SLE,-,-,90,161,132,774,22,18,1197,100,160,138,877,33,19,1327,5734
2020,Solomon Islands,SLB,-,-,0,0,0,6,0,0,6,0,0,0,7,0,0,7,37
2020,Somalia,SOM,-,-,42515,68287,57362,165092,11997,1297,346550,43591,69275,57856,214030,11089,1818,397659,812356
2020,Spain,ESP,-,-,0,6,5,0,0,0,11,0,0,9,0,7,0,16,52
2020,Viet Nam,VNM,-,-,35,77,64,446,215,5,842,45,84,60,734,289,18,1230,316728
2020,Saint Kitts and Nevis,KNA,-,-,0,0,0,0,0,0,0,0,0,0,0,0,0,0,54
2020,Sao Tome and Principe,STP,-,-,0,5,0,11,0,0,16,0,0,0,7,0,0,7,28
2020,Sudan,SDN,-,-,65915,86392,59672,169070,13985,281,395315,68066,88332,58805,123291,10835,387,349716,787823
2020,Suriname,SUR,-,-,0,0,0,0,0,0,0,0,0,0,0,0,0,0,17
2020,South Sudan,SSD,-,-,157795,294479,190185,459916,44525,0,1146900,160905,301230,208158,343769,27245,5,1041312,2188785
2020,Slovakia,SVK,-,-,0,0,0,6,19,15,40,0,0,0,16,35,21,72,1368
2020,Slovenia,SVN,-,-,0,0,0,0,0,0,0,0,0,0,0,6,0,6,17
2020,Eswatini,SWZ,-,-,0,0,0,12,0,0,12,0,0,5,14,0,0,19,198
2020,Sweden,SWE,-,-,0,8,0,0,0,0,8,0,0,0,0,0,0,0,8
2020,Switzerland,CHE,-,-,0,0,0,0,0,0,0,0,0,0,0,0,0,0,5
2020,Syrian Arab Rep.,SYR,-,-,421433,594767,374499,1425512,103720,8471,2928402,434378,639297,426263,1763399,92766,13946,3370049,6702910
2020,United Rep. of Tanzania,TZA,-,-,11,0,6,62,0,34,113,5,24,10,49,0,14,102,689
2020,Turks and Caicos Islands,TCA,-,-,0,0,0,0,0,0,0,0,0,0,0,0,0,0,14
2020,Thailand,THA,-,-,0,5,0,34,0,5,44,0,0,5,13,0,5,23,174
2020,Tajikistan,TJK,-,-,74,118,54,276,11,14,547,78,113,59,320,9,19,598,2219
2020,Turkmenistan,TKM,-,-,5,10,13,33,0,5,66,5,11,5,28,0,7,56,498
2020,Timor-Leste,TLS,-,-,0,0,0,0,0,0,0,0,0,0,0,0,0,0,11
2020,Togo,TGO,-,-,75,287,314,1246,123,56,2101,80,287,266,1858,202,115,2808,7704
2020,Tonga,TON,-,-,0,0,0,0,0,0,0,0,0,0,0,0,0,0,31
2020,Trinidad and Tobago,TTO,-,-,0,0,0,0,0,0,0,0,0,0,5,0,0,5,295
2020,Tunisia,TUN,-,-,10,17,18,105,7,14,171,15,14,10,101,7,47,194,1636
2020,Türkiye,TUR,-,-,988,2272,2069,14651,2603,1142,23725,1034,2384,2190,20069,2611,1687,29975,93730
2020,United Arab Emirates,ARE,-,-,5,7,0,9,0,0,21,0,8,0,14,0,0,22,181
2020,Uganda,UGA,-,-,51,105,55,523,20,59,813,37,95,90,972,46,59,1299,7442
2020,Ukraine,UKR,-,-,41,133,94,635,201,175,1279,43,151,71,451,98,164,978,35156
2020,Uruguay,URY,-,-,0,0,0,0,0,0,0,0,0,0,0,0,0,0,15
2020,United States of America,USA,-,-,6,17,18,27,10,0,78,5,17,25,29,12,0,88,349
2020,Uzbekistan,UZB,-,-,10,8,12,72,9,44,155,0,34,14,59,7,40,154,3112
2020,Saint Vincent and the Grenadines,VCT,-,-,0,0,0,0,0,0,0,0,0,0,5,0,0,5,742
2020,Venezuela (Bolivarian Republic of),VEN,-,-,114,249,192,1447,174,232,2408,171,297,179,1635,97,225,2604,171112
2020,Western Sahara,ESH,-,-,0,0,0,24,0,0,24,0,0,0,87,0,0,87,116925
2020,Yemen,YEM,-,-,685,1355,1211,4612,400,170,8433,686,1543,1269,9334,520,803,14155,32433
2020,Zambia,ZMB,-,-,0,0,11,34,0,0,45,0,0,5,25,0,0,30,252
2020,Zimbabwe,ZWE,-,-,34,127,227,1914,64,16,2382,39,133,203,2311,60,20,2766,8575
2020,Stateless,XXA,-,-,349,682,559,2394,157,215,4356,353,731,667,4724,279,414,7168,53725
2020,Tibetan,TIB,-,-,0,0,0,0,0,6897,6897,0,0,0,0,0,5649,5649,12561
2020,Curacao ,CUW,-,-,0,0,0,0,0,0,0,0,0,0,0,0,0,0,35
2020,Unknown ,,-,-,2488,2150,1691,8138,633,3512,18612,2647,2415,2137,15289,790,4734,28012,184067
2021,Afghanistan,AFG,-,-,169500,229719,139249,532857,43610,11043,1125978,179005,241719,150521,609019,57863,98167,1336294,2712869
2021,Albania,ALB,-,-,32,109,110,589,39,8,887,40,132,98,548,39,22,879,19847
2021,Algeria,DZA,-,-,40,77,35,376,21,34,583,42,84,52,546,49,37,810,6003
2021,Angola,AGO,-,-,62,160,166,792,70,20,1270,77,164,165,665,124,51,1246,11403
2021,Antigua and Barbuda,ATG,-,-,0,0,0,7,0,0,7,0,0,0,0,0,0,0,105
2021,Egypt,EGY,-,-,146,326,249,865,76,23,1685,97,325,257,1320,64,65,2128,27498
2021,Argentina,ARG,-,-,0,0,0,16,0,0,16,0,0,5,5,8,0,18,124
2021,Armenia,ARM,-,-,47,147,110,888,286,19,1497,49,162,151,957,211,54,1584,12255
2021,Australia,AUS,-,-,0,5,0,0,0,0,5,0,0,6,0,0,0,6,16
2021,Austria,AUT,-,-,0,5,0,0,0,0,5,5,0,0,0,0,0,5,23
2021,Azerbaijan,AZE,-,-,93,236,179,1679,519,53,2759,102,304,240,1599,347,110,2702,39478
2021,Bahrain,BHR,-,-,0,9,12,10,0,0,31,10,6,5,51,0,0,72,416
2021,Barbados,BRB,-,-,0,8,0,29,0,0,37,0,5,5,11,0,0,21,265
2021,Burundi,BDI,-,-,28394,31775,21139,66345,4070,32,151755,28340,32394,21785,76452,4043,65,163079,323635
2021,Belgium,BEL,-,-,0,0,0,7,0,0,7,0,0,0,0,0,0,0,29
2021,Benin,BEN,-,-,5,11,6,61,0,0,83,7,13,8,80,5,0,113,730
2021,Bangladesh,BGD,-,-,27,76,32,347,11,28,521,25,75,54,1280,35,52,1521,22672
2021,Bahamas,BHS,-,-,10,15,8,89,0,24,146,6,17,11,57,0,20,111,736
2021,Bhutan,BTN,-,-,125,370,346,1764,352,0,2957,126,387,417,1976,533,0,3439,6702
2021,Burkina Faso,BFA,-,-,1578,2194,948,4471,361,0,9552,1502,2141,905,2773,394,0,7715,20209
2021,Belarus,BLR,-,-,0,18,15,89,12,75,209,0,15,12,88,19,137,271,4632
2021,Bolivia (Plurinational State of),BOL,-,-,0,12,9,27,6,0,54,0,5,0,46,6,0,57,549
2021,Botswana,BWA,-,-,0,0,0,6,0,0,6,0,0,5,7,0,0,12,122
2021,Brazil,BRA,-,-,65,19,9,34,5,0,132,76,20,11,49,0,0,156,1954
2021,Bosnia and Herzegovina,BIH,-,-,10,44,38,597,234,0,923,16,40,32,486,162,0,736,18189
2021,Bulgaria,BGR,-,-,0,9,0,22,8,0,39,0,0,0,26,34,0,60,455
2021,Belize,BLZ,-,-,0,7,0,5,0,0,12,7,0,0,5,0,0,12,81
2021,Cambodia,KHM,-,-,10,14,26,194,9,0,253,16,15,20,166,24,0,241,12072
2021,Canada,CAN,-,-,0,0,9,7,0,0,16,0,0,8,0,0,0,8,60
2021,Central African Rep.,CAF,-,-,50048,95893,57097,169079,12538,0,384655,50276,95154,55379,130647,10986,0,342442,737658
2021,Cayman Islands,CYM,-,-,0,0,0,0,0,0,0,0,0,0,0,0,0,0,5
2021,Chad,TCD,-,-,539,757,572,1723,144,26,3761,534,775,519,1801,147,26,3802,11771
2021,China,CHN,-,-,142,130,81,1983,118,84,2538,154,175,113,2428,188,59,3117,170222
2021,Chile,CHL,-,-,189,10,5,73,37,0,314,183,10,0,59,69,0,321,987
2021,Cameroon,CMR,-,-,4635,8978,5252,20428,1739,29,41061,4727,8865,4863,15514,1089,20,35078,125477
2021,Congo,COG,-,-,60,186,342,2099,78,5,2770,46,194,345,2607,121,21,3334,14253
2021,Dem. Rep. of the Congo,COD,-,-,65678,93624,65232,195059,13631,69,433293,66594,93749,66086,181097,11178,61,418765,908401
2021,Comoros,COM,-,-,0,5,0,5,0,0,10,0,0,0,0,0,0,0,1670
2021,Colombia,COL,-,-,3192,4822,7386,29592,3500,59,48551,3109,4731,7186,31181,4243,41,50491,115792
2021,Costa Rica,CRI,-,-,17,0,10,0,0,0,27,11,0,0,13,0,0,24,235
2021,Cuba,CUB,-,-,38,90,55,1757,98,17,2055,29,79,71,3071,124,19,3393,11534
2021,Cabo Verde,CPV,-,-,0,0,0,0,0,0,0,0,0,0,0,0,0,0,10
2021,Cyprus,CYP,-,-,0,0,0,0,0,0,0,0,0,0,0,0,0,0,5
2021,Czechia,CZE,-,-,0,0,0,36,124,0,160,0,6,0,56,202,0,264,758
2021,Denmark,DNK,-,-,0,0,0,0,0,0,0,0,0,0,0,0,0,0,8
2021,Djibouti,DJI,-,-,6,25,0,61,0,0,92,5,21,23,99,0,0,148,2607
2021,Dominica,DMA,-,-,0,0,0,5,0,0,5,0,0,0,0,0,0,0,54
2021,Dominican Rep.,DOM,-,-,0,5,0,49,0,0,54,0,6,5,24,0,0,35,635
2021,Ecuador,ECU,-,-,8,10,15,47,0,0,80,7,10,11,36,0,0,64,1825
2021,Equatorial Guinea,GNQ,-,-,0,5,5,14,0,0,24,0,0,5,0,8,0,13,168
2021,Eritrea,ERI,-,-,13709,27217,22668,111030,7046,66,181736,14792,28088,24272,121635,7822,52,196661,511911
2021,Estonia,EST,-,-,0,0,0,0,0,0,0,0,0,0,5,0,0,5,271
2021,Ethiopia,ETH,-,-,5829,8221,5977,32820,1623,56,54526,6234,8773,6699,48969,2348,99,73122,149130
2021,Fiji,FJI,-,-,0,0,0,0,0,0,0,0,0,0,0,0,0,0,414
2021,Finland,FIN,-,-,0,0,0,0,0,0,0,0,0,0,0,0,0,0,5
2021,France,FRA,-,-,0,0,0,0,0,0,0,0,0,5,8,0,0,13,38
2021,Gabon,GAB,-,-,0,0,0,17,0,0,17,0,0,0,7,0,0,7,620
2021,Gambia,GMB,-,-,93,71,20,378,0,0,562,64,59,32,753,5,0,913,11042
2021,Palestinian,PSE,-,-,304,795,653,3664,804,35027,41247,318,857,702,4734,849,35075,42535,103581
2021,United Kingdom of Great Britain and Northern Ireland,GBR,-,-,0,8,0,5,0,0,13,9,6,0,5,0,0,20,101
2021,Georgia,GEO,-,-,18,69,45,394,84,33,643,19,91,62,435,52,26,685,9754
2021,Germany,DEU,-,-,0,0,0,0,0,0,0,0,0,0,0,0,0,0,59
2021,Ghana,GHA,-,-,31,905,1320,2653,428,0,5337,32,938,1323,1615,220,0,4128,14251
2021,Guinea-Bissau,GNB,-,-,9,5,5,51,0,0,70,5,6,5,88,5,0,109,2039
2021,Greece,GRC,-,-,0,0,0,0,6,0,6,0,0,0,5,33,0,38,87
2021,Grenada,GRD,-,-,0,0,0,0,0,0,0,0,0,0,0,0,0,0,52
2021,Guatemala,GTM,-,-,156,262,192,963,15,21,1609,136,257,216,1001,28,16,1654,26927
2021,Guinea,GIN,-,-,482,318,90,1528,13,28,2459,378,236,84,1622,11,15,2346,34403
2021,Guyana,GUY,-,-,0,0,5,9,0,0,14,0,0,5,5,0,0,10,285
2021,Haiti,HTI,-,-,34,167,113,1954,40,65,2373,26,126,101,2361,13,87,2714,29454
2021,"China, Hong Kong SAR",HKG,-,-,0,5,0,5,0,0,10,0,0,0,7,0,0,7,96
2021,Honduras,HND,-,-,1322,2298,1449,8829,104,44,14046,1349,2412,1788,11435,197,26,17207,51687
2021,Croatia,HRV,-,-,0,0,7,94,49,0,150,0,0,0,82,101,0,183,18083
2021,Hungary,HUN,-,-,34,31,24,226,62,58,435,73,65,20,273,139,52,622,4653
2021,Iceland,ISL,-,-,0,0,0,0,0,0,0,0,0,0,0,0,0,0,5
2021,Cote d'Ivoire,CIV,-,-,981,1759,1587,6003,470,0,10800,977,1791,1518,6605,325,0,11216,39940
2021,India,IND,-,-,40,55,49,641,15,70,870,41,77,51,896,39,51,1155,14230
2021,Indonesia,IDN,-,-,0,11,0,940,5,0,956,0,12,5,28,5,0,50,13962
2021,Ireland,IRL,-,-,0,0,5,0,0,0,5,0,0,0,0,0,0,0,5
2021,Iran (Islamic Rep. of),IRN,-,-,1090,1925,1590,16537,1784,47,22973,1011,2045,1813,26824,2537,173,34403,142994
2021,Iraq,IRQ,-,-,5893,14994,12393,54686,6904,76,94946,6276,16197,13676,76548,6198,138,119033,343899
2021,Israel,ISR,-,-,0,5,0,23,0,0,28,6,5,0,26,0,0,37,453
2021,Italy,ITA,-,-,0,9,0,7,0,0,16,0,7,0,8,0,0,15,61
2021,Jamaica,JAM,-,-,7,0,6,78,0,16,107,8,0,6,153,0,5,172,2419
2021,Jordan,JOR,-,-,29,60,25,387,28,36,565,40,58,63,356,12,35,564,2981
2021,Japan,JPN,-,-,0,0,8,6,0,0,14,0,0,0,9,0,0,9,39
2021,Kazakhstan,KAZ,-,-,0,15,10,62,23,41,151,0,13,7,72,6,44,142,3198
2021,Kenya,KEN,-,-,196,556,336,1340,179,25,2632,243,569,370,1039,153,17,2391,7529
2021,Kyrgyzstan,KGZ,-,-,11,22,15,85,8,18,159,15,24,22,80,5,11,157,3035
2021,Rep. of Korea,KOR,-,-,0,5,0,9,5,0,19,0,0,0,8,0,0,8,117
2021,Dem. People's Rep. of Korea,PRK,-,-,0,0,0,32,7,0,39,0,0,0,48,11,0,59,528
2021,Kuwait,KWT,-,-,0,22,0,47,0,0,69,0,5,19,83,0,0,107,1702
2021,Lao People's Dem. Rep.,LAO,-,-,0,0,0,0,6,0,6,0,0,0,29,13,0,42,6778
2021,Liberia,LBR,-,-,90,190,165,968,56,0,1469,71,168,191,897,72,0,1399,5384
2021,Libya,LBY,-,-,97,312,174,804,28,35,1450,131,352,197,1484,63,64,2291,19090
2021,Saint Lucia,LCA,-,-,0,0,0,9,0,0,9,0,0,0,0,0,0,0,457
2021,Lebanon,LBN,-,-,92,168,141,798,97,25,1321,71,222,150,691,64,40,1238,6061
2021,Lesotho,LSO,-,-,0,0,0,0,0,0,0,0,0,0,0,0,0,0,6
2021,Liechtenstein,LIE,-,-,0,0,0,0,0,0,0,0,0,0,0,0,0,0,5
2021,Sri Lanka,LKA,-,-,110,213,186,1419,411,30131,32470,115,238,195,3927,427,28618,33520,151112
2021,Lithuania,LTU,-,-,0,0,0,0,0,0,0,0,0,0,5,0,0,5,54
2021,Latvia,LVA,-,-,0,0,0,5,0,0,5,0,0,0,11,0,0,11,122
2021,Madagascar,MDG,-,-,0,0,0,0,0,0,0,0,0,5,9,0,0,14,425
2021,Mauritania,MRT,-,-,1200,3416,2736,6700,794,0,14846,1297,3498,2623,6149,907,0,14474,39279
2021,North Macedonia,MKD,-,-,11,40,47,273,31,0,402,14,50,50,199,43,0,356,1842
2021,Rep. of Moldova,MDA,-,-,5,15,12,68,5,8,113,5,12,5,64,5,9,100,2190
2021,Maldives,MDV,-,-,0,0,5,0,0,0,5,0,0,0,0,0,0,0,80
2021,Mexico,MEX,-,-,83,161,102,753,7,33,1139,81,141,103,776,5,41,1147,16403
2021,Marshall Islands,MHL,-,-,0,0,0,0,0,0,0,0,0,0,0,0,0,0,7
2021,Mali,MLI,-,-,11185,21695,14522,36797,3070,0,87269,11022,21397,14003,24725,2981,0,74128,183392
2021,Malaysia,MYS,-,-,0,0,0,16,0,0,16,0,0,0,17,0,0,17,1182
2021,Malawi,MWI,-,-,5,17,5,88,0,0,115,0,7,5,59,0,0,71,513
2021,Mongolia,MNG,-,-,23,44,18,146,17,10,258,17,39,29,99,11,0,195,2508
2021,Morocco,MAR,-,-,44,88,26,393,16,0,567,61,91,30,240,19,0,441,5385
2021,Mozambique,MOZ,-,-,0,0,0,21,0,0,21,0,0,0,5,0,0,5,90
2021,Malta,MLT,-,-,0,0,0,0,0,0,0,0,0,0,0,0,0,0,7
2021,Montenegro,MNE,-,-,0,6,13,112,19,0,150,5,12,9,75,12,0,113,623
2021,Mauritius,MUS,-,-,0,5,0,9,0,0,14,0,5,0,7,0,0,12,198
2021,Myanmar,MMR,-,-,84048,117092,71463,277304,18607,65,568579,87832,121646,77680,275144,22802,84,585188,1177327
2021,Namibia,NAM,-,-,0,0,0,5,0,0,5,0,0,0,6,0,0,6,441
2021,Nepal,NPL,-,-,5,0,0,43,0,0,48,0,10,8,53,0,0,71,7029
2021,Netherlands,NLD,-,-,9,0,0,7,0,0,16,0,15,0,5,0,0,20,58
2021,Niger,NER,-,-,2610,3125,1583,3785,334,0,11437,2462,2795,1142,2595,219,0,9213,21901
2021,Nicaragua,NIC,-,-,76,176,116,2486,275,43,3172,88,158,134,2493,219,40,3132,11041
2021,Nigeria,NGA,-,-,25200,52840,25125,75082,6334,69,184650,24414,50616,23067,54390,6115,64,158666,383660
2021,Niue,NIU,-,-,0,0,0,0,0,0,0,0,0,0,0,0,0,0,11
2021,Norway,NOR,-,-,0,0,0,0,0,0,0,0,0,0,0,0,0,0,5
2021,Nauru,NRU,-,-,0,0,0,0,0,0,0,0,0,0,0,0,0,0,5
2021,New Zealand,NZL,-,-,0,0,0,0,0,0,0,0,0,0,7,0,0,7,33
2021,Oman,OMN,-,-,0,0,0,8,0,0,8,0,0,0,0,0,0,0,53
2021,Pakistan,PAK,-,-,7525,8864,5362,18962,2001,65,42779,6931,9126,4978,19856,2421,39,43351,132818
2021,Panama,PAN,-,-,13,5,5,0,0,0,23,30,5,0,5,0,0,40,118
2021,Paraguay,PRY,-,-,0,5,5,9,0,0,19,0,0,0,10,5,0,15,125
2021,Peru,PER,-,-,11,18,10,313,89,0,441,13,19,5,289,99,0,425,3521
2021,Philippines,PHL,-,-,6,0,5,63,8,0,82,0,13,5,32,0,0,50,521
2021,Papua New Guinea,PNG,-,-,0,0,0,0,0,0,0,0,0,0,0,0,0,0,507
2021,Poland,POL,-,-,0,0,6,35,134,0,175,0,5,0,74,330,0,409,887
2021,Portugal,PRT,-,-,0,6,0,0,0,0,6,0,0,0,5,0,0,5,26
2021,Qatar,QAT,-,-,0,0,0,0,0,0,0,0,0,0,5,0,0,5,47
2021,Romania,ROU,-,-,0,7,5,65,29,33,139,0,5,16,81,72,29,203,1417
2021,South Africa,ZAF,-,-,0,14,26,70,10,0,120,5,17,15,34,10,0,81,643
2021,Russian Federation,RUS,-,-,212,852,793,3363,477,167,5864,218,921,825,2920,312,214,5410,68547
2021,Rwanda,RWA,-,-,23758,30388,21550,42554,2570,25,120845,20672,31761,22758,40775,3375,23,119364,248219
2021,El Salvador,SLV,-,-,310,813,618,4175,99,22,6037,315,906,646,5181,126,25,7199,52041
2021,Saudi Arabia,SAU,-,-,10,35,20,156,0,30,251,15,19,29,150,0,14,227,2167
2021,Serbia and Kosovo: S/RES/1244 (1999),SRB,-,-,64,220,292,2956,921,15,4468,65,267,288,2689,784,5,4098,31735
2021,Senegal,SEN,-,-,82,638,559,1653,323,0,3255,97,610,588,1612,307,0,3214,15129
2021,Seychelles,SYC,-,-,0,0,0,0,0,0,0,0,0,0,0,0,0,0,14
2021,Singapore,SGP,-,-,0,0,0,0,0,0,0,0,0,7,0,0,0,7,34
2021,Sierra Leone,SLE,-,-,88,201,145,981,16,0,1431,108,155,167,1072,20,10,1532,6615
2021,Solomon Islands,SLB,-,-,0,0,0,6,0,0,6,0,0,0,7,0,0,7,38
2021,Somalia,SOM,-,-,46984,68316,56380,165452,11231,74,348437,49066,70208,59006,169328,11022,88,358718,776678
2021,Spain,ESP,-,-,0,0,11,0,0,0,11,0,0,9,11,0,0,20,55
2021,Viet Nam,VNM,-,-,36,88,64,470,228,5,891,50,89,70,752,304,9,1274,317737
2021,Saint Kitts and Nevis,KNA,-,-,0,0,0,0,0,0,0,0,0,0,0,0,0,0,47
2021,Sao Tome and Principe,STP,-,-,0,0,0,6,0,0,6,0,0,0,0,0,0,0,6
2021,Sudan,SDN,-,-,61621,87930,63985,181291,14890,207,409924,63518,90331,63654,136166,11717,67,365453,825290
2021,Suriname,SUR,-,-,0,0,0,0,0,0,0,0,0,0,0,0,0,0,22
2021,South Sudan,SSD,-,-,155207,311670,208017,506030,48504,0,1229428,157768,317355,227118,397906,32321,0,1132468,2362759
2021,Slovakia,SVK,-,-,0,6,0,13,17,15,51,0,6,0,25,35,21,87,1426
2021,Slovenia,SVN,-,-,0,0,0,0,0,0,0,0,0,0,0,6,0,6,17
2021,Eswatini,SWZ,-,-,0,0,5,12,0,0,17,0,0,5,13,0,0,18,165
2021,Sweden,SWE,-,-,0,0,0,9,0,0,9,0,0,0,0,0,0,0,9
2021,Syrian Arab Rep.,SYR,-,-,402112,635076,373836,1459370,108154,284,2978832,427207,674125,406489,1808242,96782,626,3413471,6848865
2021,United Rep. of Tanzania,TZA,-,-,6,19,0,103,0,0,128,5,28,15,81,0,0,129,752
2021,Turks and Caicos Islands,TCA,-,-,0,0,0,0,0,0,0,0,0,0,0,0,0,0,14
2021,Thailand,THA,-,-,0,5,0,28,5,0,38,0,0,0,14,6,0,20,181
2021,Tajikistan,TJK,-,-,70,133,66,300,12,5,586,75,137,62,364,12,23,673,2412
2021,Turkmenistan,TKM,-,-,5,10,10,33,0,7,65,5,9,5,30,5,7,61,563
2021,Timor-Leste,TLS,-,-,0,0,0,0,0,0,0,0,0,0,0,0,0,0,11
2021,Togo,TGO,-,-,61,248,276,1308,138,0,2031,53,251,275,1859,227,0,2665,7985
2021,Tonga,TON,-,-,0,0,0,0,0,0,0,0,0,0,0,0,0,0,28
2021,Trinidad and Tobago,TTO,-,-,0,0,0,14,0,0,14,0,5,0,6,0,0,11,285
2021,Tunisia,TUN,-,-,10,16,19,122,6,0,173,12,17,15,121,14,0,179,2201
2021,Türkiye,TUR,-,-,1232,3285,2317,13724,2195,43,22796,1349,3404,2503,20318,2501,51,30126,105019
2021,United Arab Emirates,ARE,-,-,0,5,10,7,0,0,22,0,8,0,14,0,0,22,160
2021,Uganda,UGA,-,-,56,133,73,712,23,27,1024,65,89,106,1173,62,23,1518,7887
2021,Ukraine,UKR,-,-,110,327,198,1433,336,144,2548,135,378,202,1148,168,127,2158,27562
2021,Uruguay,URY,-,-,5,0,0,0,0,0,5,8,5,0,0,0,0,13,45
2021,United States of America,USA,-,-,20,35,25,29,11,0,120,16,23,28,38,11,0,116,426
2021,Uzbekistan,UZB,-,-,10,8,16,74,10,27,145,0,33,9,69,7,48,166,3014
2021,Saint Vincent and the Grenadines,VCT,-,-,0,5,0,10,0,0,15,0,0,0,0,0,0,0,467
2021,Venezuela (Bolivarian Republic of),VEN,-,-,373,1440,999,10870,1074,27,14783,448,1520,1045,11074,644,26,14757,199202
2021,Samoa,WSM,-,-,0,0,0,0,0,0,0,0,0,0,0,0,0,0,5
2021,Western Sahara,ESH,-,-,0,0,0,27,0,0,27,0,0,0,88,0,0,88,117041
2021,Yemen,YEM,-,-,741,1497,1319,5226,411,101,9295,765,1604,1464,11692,632,48,16205,37615
2021,Zambia,ZMB,-,-,0,0,5,41,0,0,46,0,0,5,25,0,0,30,255
2021,Zimbabwe,ZWE,-,-,42,113,216,2089,90,16,2566,39,118,185,2467,75,15,2899,8115
2021,Stateless,XXA,-,-,371,758,675,2722,186,94,4806,365,806,800,5326,330,116,7743,56534
2021,Tibetan,TIB,-,-,0,0,0,0,0,6897,6897,0,0,0,0,0,5643,5643,12593
2021,Curacao ,CUW,-,-,0,0,0,0,0,0,0,0,0,0,0,0,0,0,35
2021,Unknown ,,-,-,2547,2703,2054,10885,1082,0,19271,2665,3024,2441,18097,1260,0,27487,100632
